border_size=1
usage=map

Gs^Fdf      , Gs^Fdf      , Gs^Fdw      , Gs^Fdf      , Gs^Fdf      , Gs^Fdw      , Gg          , Gg          , Gg          , Gg          , Re^Gvs      , Gg          , Re^Gvs      , Re^Gvs      , Re^Gvs      , Re^Gvs      , Re^Gvs      , Gg          , Rp          , Gg          , Re^Gvs      , Re^Gvs      , Re^Gvs      , Gg          , Gg          , Gg          , Re^Gvs      , Re^Gvs      , Re^Gvs      , Re^Gvs      , Re^Gvs      , Gs^Fdf      , Gs^Fdw      , Gs^Fdf      , Gs^Fdw      , Gs^Fdf      , Gs^Fdw      , Gs^Fdf      , Gs^Fdf      , Gs^Fdw      , Gs^Fdf      , Gg          , Gg          , Rr          , Gs^Fdf      , Gs^Fdf      , Gs^Fdf      , Gs^Fdf      , Gs^Fdf      , Gs^Fdf      
Gs^Fdw      , Gs^Fdf      , Gs^Fdf      , Gs^Fdw      , Gs^Fdf      , Gs^Fdw      , Gg          , Gg          , Gg          , Gg          , Ggf         , Re^Gvs      , Re^Gvs      , Re^Gvs      , Ggf         , Gg          , Gg          , Gg          , Rp          , Gg          , Re^Gvs      , Re^Gvs      , Re^Gvs      , Gg          , Gg          , Ggf         , Gg          , Re^Gvs      , Re^Gvs      , Re^Gvs      , Gg          , Gs^Fdf      , Gs^Fdf      , Gs^Fdw      , Gs^Fdf      , Gs^Fdf      , Gs^Fdf      , Gs^Fdw      , Gs^Fdw      , Gs^Fdf      , Gs^Fdf      , Gg          , Rr          , Rr          , Gs^Fdw      , Gs^Fdw      , Gs^Fdf      , Gs^Fdf      , Gs^Fdf      , Gs^Fdf      
Gs^Fdf      , Gs^Fdf      , Gs^Fdf      , Gs^Fdf      , Ce          , Gg          , Gg          , Ggf         , Gg          , Gg          , Re^Gvs      , Re^Gvs      , Re^Gvs      , Gg          , Gg          , Gg^Vh       , Gg          , Gg          , Rp          , Gg          , Re^Gvs      , Re^Gvs      , Gg          , Gg^Vh       , Gg          , Gg          , Gg          , Gg          , Gg          , Ggf         , Gg          , Gg          , Ww          , Gg          , Ww          , Gg          , Gg          , Gg          , Gg^Vh       , Gg          , Gg          , Rr          , Gs^Fdf      , Gs^Fdf      , Gs^Fdf      , Gs^Fdf      , Gs^Fdf      , Gs^Fdf      , Gs^Fdf      , Gs^Fdf      
Gs^Fdw      , Gs^Fdf      , Gs^Fdw      , 5 Ke        , Ce          , Ce          , Gg          , Gg          , Gg          , Gg          , Gg          , Gg          , Gg          , Gg          , Ww          , Gg^Vh       , Ww          , Gg          , Rr          , Gg          , Gg          , Gg          , Gg^Vh       , Gg          , Ww          , Gg          , Ww          , Ww          , Ww          , Ww          , Ww          , Ww          , Ww          , Ww          , Ww          , Ww          , Ww          , Gg          , Gg          , Gg          , Rr          , 1 Rr        , Gg          , Gs^Fdw      , Gs^Fdf      , Gs^Fdf      , Gg          , Gs^Fdf      , Gg          , Gs^Fdf      
Gs^Fdf      , Gs^Fdf      , Ce          , Ce          , Gg          , Gg          , Gg          , Gg          , Ww          , Ww          , Ww          , Ww          , Ww          , Ww          , Ww          , Ww          , Ww          , Ww          , Ww^Bw|      , Ww          , Ww          , Ww          , Ww          , Ww          , Ww          , Ww          , Ww          , Ww          , Ww          , Ww          , Ww          , Ww          , Wo          , Wo          , Wo          , Ww          , Ww          , Ww          , Rr          , Rr          , Gg          , Gg          , Gg          , Gg^Vh       , Gg          , Gg          , Gg          , Gg          , Gg          , Gg          
Rr          , Rr          , Rr          , Gg          , Gg          , Gg^Vh       , Ww          , Ww          , Ww          , Ww          , Ww          , Ww          , Ww          , Ww          , Ch          , Ch          , Ww          , Ww          , Rr          , Ww          , Ch          , Ww          , Ww          , Ww          , Wo          , Ww          , Wo          , Ww          , Wo          , Wo          , Wo          , Wo          , Hh          , Ch          , Ch          , Ww          , Ww^Bw/      , Ww^Bw/      , Ww          , Gg          , Ww          , Gg^Vh       , Gg          , Gg          , Re^Gvs      , Re^Gvs      , Gg          , Gg          , Gg          , Gg          
Gs^Fdw      , Gs^Fdf      , Gs^Fdw      , Rr          , Rr          , Ww          , Ww          , Ww          , Wo          , Wo          , Ch          , Wo          , Wo          , Wo          , Gg^Vh       , Gg          , Ggf         , Gg          , Rr          , Gg          , Gg          , Ch          , Gg^Vh       , Hh          , Hh          , Wo          , Hh          , Wo          , Hh          , Hh          , Hh          , Hh          , Rr          , Gg^Vh       , Rr          , Gg          , Rr          , Ww          , Ww          , Ww          , Ww          , Gg          , Re^Gvs      , Re^Gvs      , Gs^Fdw      , Gs^Fdf      , Gg          , Gg          , Gg          , Gg          
Gg          , Gg^Vh       , Gg          , Gg          , Ww          , Ww^Bw\      , Ww^Bw\      , Ww          , Rr          , Ch          , Gg^Vh       , Hh          , Hh          , Hh          , Gg          , Gg          , Gg          , Gg          , Rr          , Gg          , Ggf         , Gg          , Gg          , Gg          , Gg          , Hh          , Rr          , Hh          , Rr          , Rr          , Rr          , Rr          , Gg          , Gg          , Gg          , Rr          , Rr          , Ch          , Ch          , Ww          , Ww          , Gg          , Gg          , Re^Gvs      , Gs^Fdf      , Gs^Fdw      , Gs^Fdf      , Gg          , Gg          , Gg          
Gs^Fdw      , Gs^Fdf      , Gg          , Gg^Vh       , Ww          , Ww          , Rr          , Rr          , Gg          , Rr          , Rr          , Gg          , Rr          , Rr          , Rr          , Rr          , Rr          , Rr          , Rr          , Rr          , Rr          , Gg          , Rr          , Gg          , Rr          , Rr          , Gg          , Rr          , Ch          , Ch          , Gg          , Rr          , Gg          , Ch          , Ch          , Gg          , Rr          , Gg          , Gg^Vh       , Wo          , Ww          , Gg          , Gg          , Gs^Fdf      , Gs^Fdf      , Gs^Fdf      , Gs^Fdf      , Gs^Fdf      , Gs^Fdf      , Gg          
Gs^Fdf      , Gs^Fdw      , Gg          , Ww          , Ww          , Ww          , Rr          , Gg          , Gg          , Gg          , Gg          , Rr          , Gg          , Gg          , Gg          , Gg          , Ggf         , Gg          , Rr          , Gg          , Gg          , Rr          , Rr          , Rr          , Gs^Fdf      , Rr          , Rr          , Gg          , Ch          , Rp^Vhc      , Ch          , Ch          , Ch          , Rp^Vhc      , Ch          , Gg          , Rr          , Gg          , Hh          , Wo          , Ww          , Gg          , Gg          , Gs^Fdf      , Gs^Fdw      , Gs^Fdf      , Gs^Fdf      , Gs^Fdf      , Gs^Fdf      , Gs^Fdf      
Gs^Fdf      , Gs^Fdf      , Ww          , Ww          , Wo          , Ch          , Rr          , Gg          , Ch          , Ch          , Gg          , Rr          , Gg          , Ch          , Ch          , Gg          , Rr          , Rr          , Gs^Fdw      , Rr          , Ce          , Ce          , Rr          , Gs^Fdw      , Gs^Fdf      , Gs^Fdf      , Rr          , Gg          , Gg          , Gg          , Ch          , 6 Kh        , Ch          , Gg          , Gg          , Gg          , Rr          , Gg          , Hh          , Wo          , Ww          , Gg          , Gg          , Gg          , Gs^Fdf      , Gs^Fdf      , Gs^Fdf      , Gs^Fdf      , Gg          , Gs^Fdf      
Gs^Fdw      , Gs^Fdf      , Ww          , Wo          , Wo          , Ch          , Rr          , Gg          , Ch          , Rp^Vhc      , Ch          , Ch          , Ch          , Rp^Vhc      , Ch          , Gg          , Rr          , Gs^Fdf      , Gs^Fdf      , Rr          , Gg          , Ce          , Rr          , Gs^Fdf      , Gs^Fdw      , Gs^Fdf      , Rr          , Gg          , Rr          , Rr          , Gg          , Ch          , Gg          , Rr          , Rr          , Rr          , Rr          , Gg          , Hh          , Wo          , Wo          , Ww          , Gg          , Re^Gvs      , Gs^Fdw      , Gs^Fdf      , Gg          , Gg          , Gg          , Gg          
Gg          , Gg          , Ww          , Ww          , Wo          , Gg^Vh       , Rr          , Gg          , Gg          , Gg          , Ch          , 3 Kh        , Ch          , Gg          , Gg          , Gg          , Rr          , Gs^Fdf      , Gs^Fdf      , Rr          , Rr          , Gg          , Rr          , Rr          , Rr          , Rr          , Gg          , Rr          , Gg          , Gg          , Ch          , Rp^Vhc      , Ch          , Gg          , Ce          , Gg          , Rr          , Gg          , Gg          , Hh          , Wo          , Ww          , Gg          , Re^Gvs      , Gg          , Gg          , Gg          , Gg          , Gg          , Gg          
Gg          , Gg          , Ww          , Wo          , Wo          , Hh          , Gg          , Rr          , Rr          , Rr          , Gg          , Ch          , Gg          , Rr          , Rr          , Rr          , Gs^Fdw      , Gs^Fdf      , Rr          , Rr          , Rr          , Rr          , Rr          , Gg          , Gg          , Ce          , Ce          , Rr          , Gg          , Gg          , Gg          , Ch          , Gg          , Gg          , Ce          , Ce          , Rr          , Gg          , Gg          , Hh          , Wo          , Ww          , Gg          , Re^Gvs      , Re^Gvs      , Re^Gvs      , Gg          , Gg          , Gg          , Gg          
Gg          , Gg          , Ww          , Wo          , Wo          , Hh          , Gg          , Rr          , Gg          , Gg          , Ch          , Rp^Vhc      , Ch          , Gg          , Ggf         , Rr          , Rr          , Rr          , Gg          , Gg          , Rr          , Gg          , Gg          , Rr          , Rr          , Ce          , Rr          , Rr          , Rr          , Rr          , Rr          , Gg          , Rr          , Gg          , Rr          , Gg          , Rr          , Ggf         , Gg          , Hh          , Wo          , Ww          , Gg          , Re^Gvs      , Re^Gvs      , Re^Gvs      , Gg          , Gg          , Gg          , Gg          
Gg          , Gg          , Ww          , Wo          , Wo          , Hh          , Gg          , Rr          , Gg          , Gg          , Gg          , Ch          , Gg          , Gg          , Rr          , Rr          , Gg          , Gg          , Ww          , Ww          , Ww^Bw|      , Ww          , Ww          , Gg          , Gg          , Rr          , Rr          , Rr          , Gg          , Gg          , Ggf         , Rr          , Gs^Fdf      , Rr          , Gs^Fdf      , Rr          , Rr          , Gg          , Gg          , Hh          , Wo          , Ww          , Gg          , Re^Gvs      , Re^Gvs      , Re^Gvs      , Gg          , Gg          , Gg          , Gg          
Gg          , Gg          , Ww          , Ww          , Wo          , Hh          , Hh          , Rr          , Rr          , Rr          , Rr          , Gg          , Rr          , Gg          , Rr          , Gg          , Wo          , Ww          , Ch          , Rp^Vhc      , Rr          , Rp^Vhc      , Ch          , Ww          , Wo          , Gg          , Rr          , Gg          , Ce          , Ce          , Gg          , Rr          , Gs^Fdf      , Gs^Fdw      , Gs^Fdf      , Gs^Fdf      , Rr          , Gg          , Hh          , Hh          , Wo          , Ww          , Gg          , Re^Gvs      , Re^Gvs      , Re^Gvs      , Gg          , Gg          , Gg          , Gg          
Gg          , Gg          , Ww          , Ww          , Wo          , Wo          , Hh          , Gg          , Rr          , Gg          , Ce          , Rr          , Gs^Fdf      , Rr          , Rr          , Wo          , Ch          , Ch          , Gg          , Gg          , Rr          , Ggf         , Gg          , Ch          , Ch          , Wo          , Rr          , Gg          , Gg          , Ce          , Gg          , Rr          , Gs^Fdf      , Gs^Fdf      , Gs^Fdf      , Rr          , Gg          , Ggf         , Hh          , Wo          , Ww          , Ww          , Gg          , Re^Gvs      , Re^Gvs      , Re^Gvs      , Gg          , Gg          , Gs^Fdw      , Gs^Fdw      
Gg          , Gg          , Gg          , Ww          , Wo          , Wo          , Hh          , Gg          , Rr          , Ce          , Ce          , Rr          , Gs^Fdw      , Gs^Fdf      , Rr          , Wo          , Ch          , Gg          , Gg          , Gg          , Ch          , Gg          , Ggf         , Gg          , Ch          , Wo          , Rr          , Rr          , Rr          , Gg          , Rr          , Rr          , Rr          , Rr          , Rr          , Rr          , Gg          , Gg^Vh       , Wo          , Wo          , Ww          , Gg          , Re^Gvs      , Re^Gvs      , Re^Gvs      , Re^Gvs      , Gg          , Gs^Fdf      , Gs^Fdf      , Gs^Fdf      
Gg          , Gg          , Gg          , Ww          , Wo          , Wo          , Hh          , Gg          , Rr          , Gg          , Gg          , Rr          , Gs^Fdf      , Gs^Fdw      , Rr          , Ww          , Ch          , Gg          , Gg          , Ch          , 7 Kh        , Ch          , Gg          , Gg          , Ch          , Ww          , Rr          , Gg          , Ce          , Rr          , Rr          , Gg          , Ce          , Gg          , Rr          , Gg          , Gg          , Ch          , Ww          , Ww          , Gg          , Gg          , Re^Gvs      , Re^Gvs      , Gs^Fdf      , Gs^Fdw      , Gs^Fdf      , Gs^Fdf      , Gs^Fdf      , Gs^Fdf      
Gs^Fdw      , Gs^Fdf      , Ww          , Ww          , Ww          , Wo          , Gg^Vh       , Gg          , Rr          , Gg          , Rr          , Rr          , Rr          , Rr          , Rr          , Ww          , Rp^Vhc      , Gg          , Rr          , Ch          , Ch          , Ch          , Rr          , Ggf         , Rp^Vhc      , Ww          , Rr          , Ke          , Ce          , Gg          , Rr          , Ce          , Ce          , Gg          , Rr          , Gg          , Ww          , Ch          , Ww          , Ww          , Gg          , Re^Gvs      , Re^Gvs      , Re^Gvs      , Gs^Fdf      , Gs^Fdf      , Gs^Fdf      , Gs^Fdf      , Gs^Fdf      , Gs^Fdf      
Gs^Fdf      , Gs^Fdf      , Gg          , Ww          , Ww          , Wo          , Ch          , Gg          , Gg          , Rr          , Gg          , Gg          , Ggf         , Ggf         , Rr          , Ww          , Ww^Bw/      , Rr          , Gg          , Gg          , Ggf         , Gg          , Gg          , Rr          , Ww^Bw\      , Ww          , Rr          , Rr          , Rr          , Rr          , Rr          , Rr          , Rr          , Rr          , Rr          , Ch          , Ww          , Ww          , Gg          , Gg          , Gg          , Gg^Vh       , Re^Gvs      , Gs^Fdw      , Gs^Fdf      , Gs^Fdf      , Gs^Fdf      , Gs^Fdf      , Gs^Fdw      , Gs^Fdf      
Gs^Fdw      , Gs^Fdw      , Gg          , Gg          , Ww          , Ww          , Ww          , Ch          , Gg          , Rr          , Gg          , Ce          , Ce          , Gg          , Rr          , Rr          , Ww          , Rp^Vhc      , Ch          , Gg          , Gg          , Gg          , Ch          , Rp^Vhc      , Ww          , Rr          , Rr          , Gg          , Ce          , Gg          , Gg          , Rr          , Gg          , Gg          , Gg          , Rr          , Ww^Bw\      , Gg          , Gg          , Gg^Vh       , Gg          , Re^Gvs      , Re^Gvs      , Gg          , Gg          , Gs^Fdw      , Gg          , Gs^Fdf      , Gs^Fdf      , Gs^Fdf      
Gg          , Gg          , Gg          , Gg^Vh       , Gg          , Ww          , Ww          , Gg          , Gg          , Rr          , Gg          , Ce          , Rr          , Rr          , Gs^Fdf      , Rr          , Rr          , Ww          , Ww          , Ch          , Ch          , Ch          , Ww          , Ww          , Rr          , Rr          , Rr          , Gg          , Ce          , Ce          , Gg          , Rr          , Gg          , Ggf         , Ch          , Ww          , Ww          , Rr          , Rr          , Gg          , Gs^Fdw      , Re^Gvs      , Re^Gvs      , Gg^Vh       , Gg          , Gs^Fdw      , Gg          , Gg          , Gs^Fdf      , Gs^Fdf      
Gg          , Gg^Vh       , Gg          , Gg          , Gg          , Gg^Vh       , Ww          , Ww          , Ww^Bw/      , Rr          , Rr          , Rr          , Rr          , Gs^Fdf      , Gs^Fdf      , Gs^Fdf      , Rr          , Rr          , Rr          , Wo          , Wo          , Wo          , Rr          , Rr          , Ce          , Gg          , Gg          , Rr          , Rr          , Gg          , Rr          , Rr          , Gg          , Gg          , Ch          , Ww          , Ww          , Gg          , Gs^Fdw      , Rr          , Rr          , Ggf         , Gg          , Gg          , Gg          , Gg          , Gg          , Gg          , Gg          , Gs^Fdf      
Gg          , Gg          , Gs^Fdf      , Gg          , Gg          , Gg          , Rr          , Ww^Bw/      , Ww          , Ww          , Ch          , Gg          , Rr          , Gs^Fdw      , Rr          , Rr          , Gg          , Gg          , Ce          , Rr          , Rr          , Rr          , Ggf         , Ce          , Ce          , Ce          , Rr          , Rr          , Gs^Fdf      , Rr          , Gs^Fdf      , Rr          , Hh          , Gg^Vh       , Wo          , Ww          , Ww          , Gg          , Gg          , Gs^Fdf      , Gs^Fdf      , Rr          , Rr          , Gs^Fdf      , Rr          , Gg          , Gg          , Gg          , Gg          , Gg          
Gs^Fdf      , Gs^Fdw      , Gs^Fdf      , Ggf         , Rr          , Rr          , Gg          , Ww          , Wo          , Ww          , Ch          , Gg          , Rr          , Rr          , Gg          , Rr          , Rr          , Ce          , Ce          , Gg          , Rr          , Gg          , Rr          , Rr          , Rr          , Rr          , Rr          , Gs^Fdf      , Gs^Fdf      , Gs^Fdw      , Rr          , Rr          , Hh          , Wo          , Ww          , Wo          , Ww          , Ww          , Gg^Vh       , Gg          , Gg          , Gg          , Gs^Fdw      , Rr          , Gs^Fdw      , Rr          , Ce          , Ce          , Ce          , Gg          
Gs^Fdw      , Gs^Fdf      , Rp          , Rr          , Gs^Fdw      , Gg          , Gg          , Ww          , Wo          , Wo          , Wo          , Gg^Vh       , Gg          , Rr          , Ce          , Ce          , Gg          , Rr          , Rr          , Rr          , Gg          , Rr          , Rr          , Gg          , Gg          , Rr          , Gg          , Rr          , Rr          , Gs^Fdw      , Rr          , Gg          , Hh          , Wo          , Ww          , Wo          , Wo          , Ww          , Ww          , Gg          , Gg^Vh       , Gg          , Gg          , Gs^Fdf      , Gg          , Gg          , Ce          , 2 Ke        , Ce          , Rr          
Rr          , Rr          , Gs^Fdw      , Ggf         , Gg          , Gg          , Gg^Vh       , Ww          , Ww          , Ww          , Wo          , Hh          , Gg          , Rr          , Rr          , Ce          , Rr          , Rr          , Gg          , Gg          , Ch          , Gg          , Rr          , Gg          , Ch          , Gg          , Gg          , Ggf         , Gg          , Rr          , Gg          , Hh          , Wo          , Wo          , Ww          , Wo          , Wo          , Wo          , Ww          , Gg          , Gg          , Gg          , Gg          , Gg^Vh       , Gg          , Gg          , Gg          , Ce          , Gg          , Gg          
Gs^Fdw      , Gs^Fdf      , Gs^Fdf      , Gg          , Gg          , Gg          , Gg          , Gg          , Ww          , Ww          , Wo          , Hh          , Hh          , Gg          , Gg          , Rr          , Gg          , Gg          , Gg          , Ch          , Rp^Vhc      , Gg          , Ch          , Gg          , Rp^Vhc      , Ch          , Gg          , Ggf         , Rr          , Rr          , Hh          , Hh          , Wo          , Ww          , Ww          , Wo          , Wo          , Wo          , Wo          , Ww          , Ww          , Gg          , Gg          , Gg          , Gg          , Gg          , Gg          , Gs^Fdf      , Gs^Fdw      , Gs^Fdw      
Gs^Fdf      , Gs^Fdf      , Gg          , Gg          , Gg          , Gg          , Gg^Vh       , Gg          , Ww          , Ww          , Ww          , Wo          , Wo          , Hh          , Gg          , Rr          , Gg          , Gg          , Gg          , Ch          , Gg          , Ch          , 4 Kh        , Ch          , Gg          , Ch          , Gg          , Gg          , Rr          , Gg          , Hh          , Wo          , Wo          , Ww          , Ww          , Ww          , Wo          , Wo          , Wo          , Ww          , Ww          , Ss          , Ss          , Gg          , Gg          , Gg          , Gg          , Gs^Fdw      , Gs^Fdf      , Gs^Fdf      
Gs^Fdf      , Gs^Fdw      , Gg^Vh       , Gg          , Gg          , Gg          , Gg          , Gg          , Gg          , Ww          , Wo          , Ww          , Wo          , Hh          , Hh          , Rr          , Rr          , Gg          , Gg          , Gg          , Rr          , Ch          , Ch          , Ch          , Rr          , Gg          , Gg          , Rr          , Gg          , Hh          , Wo          , Wo          , Wo          , Wo          , Wo          , Ww          , Ww          , Wo          , Wo          , Wo          , Wo          , Ww          , Ww          , Ss          , Ss          , Ss          , Gg          , Gs^Fdf      , Gs^Fdf      , Gs^Fdf      
Gg          , Gg          , Gg          , Gg          , Gg          , Gg^Vh       , Gg          , Gg          , Gg          , Ww          , Wo          , Wo          , Wo          , Wo          , Hh          , Gg          , Gg          , Rr          , Rr          , Rr          , Gg          , Gg          , Rp^Vhc      , Gg          , Gg          , Rr          , Rr          , Rr          , Gg          , Hh          , Wo          , Wo          , Wo          , Wo          , Ww          , Ww          , Ss          , Ww          , Ww          , Wo          , Wo          , Wo          , Ww          , Ww          , Ww          , Ss          , Gg          , Gs^Fdf      , Gs^Fdw      , Gs^Fdf      
Gs^Fdf      , Gs^Fdf      , Gs^Fdw      , Gs^Fdf      , Gs^Fdw      , Gg          , Gg          , Gg          , Gg          , Ww          , Ww          , Ww          , Wo          , Wo          , Wo          , Hh          , Hh          , Gg          , Rr          , Gg          , Gg          , Ch          , Ch          , Ch          , Gg          , Rr          , Gg          , Gg          , Hh          , Hh          , Wo          , Wo          , Wo          , Wo          , Ww          , Ss          , Ss          , Ss          , Ss          , Ww          , Ww          , Ww          , Wo          , Wo          , Ww          , Ww          , Ww          , Gg          , Gg          , Gs^Fdw      
Gs^Fdf      , Gs^Fdw      , Gs^Fdf      , Gs^Fdf      , Gs^Fdf      , Gs^Fdf      , Gg          , Gg          , Gg          , Ww          , Ww          , Wo          , Wo          , Wo          , Wo          , Wo          , Wo          , Gg^Vh       , Ch          , Rr          , Rr          , Gg          , Gg          , Gg          , Rr          , Rr          , Ch          , Gg^Vh       , Wo          , Wo          , Wo          , Wo          , Wo          , Wo          , Ww          , Ss          , Ss          , Gg          , Gg          , Ss          , Ww          , Ww          , Ww          , Ww          , Wo          , Wo          , Ww          , Gg          , Gg          , Gg          
Gs^Fdw      , Gs^Fdf      , Gs^Fdw      , Gs^Fdf      , Gg          , Gs^Fdf      , Gs^Fdw      , Gg          , Gg          , Ww          , Ww          , Ww          , Wo          , Ww          , Ww          , Ww          , Wo          , Wo          , Ww          , Ch          , Gg          , Rr          , Rr          , Rr          , Gg          , Ch          , Wo          , Wo          , Wo          , Wo          , Wo          , Ww          , Ww          , Wo          , Wo          , Ww          , Ww          , Ss          , Ss          , Gg          , Gg          , Ss          , Ss          , Ww          , Wo          , Wo          , Ww          , Gg          , Ss          , Gg          
Gs^Fdf      , Gs^Fdf      , Gs^Fdf      , Gs^Fdw      , Gs^Fdf      , Gs^Fdw      , Gs^Fdf      , Gs^Fdf      , Gs^Fdf      , Ww          , Ww          , Ww          , Wo          , Ww          , Wo          , Wo          , Wo          , Wo          , Wo          , Ww          , Ww          , Ww          , Ww^Bw|      , Ww          , Wo          , Wo          , Wo          , Wo          , Ww          , Ww          , Wo          , Wo          , Wo          , Wo          , Wo          , Wo          , Wo          , Ww          , Ww          , Ss          , Gg          , Gg          , Ss          , Ww          , Wo          , Wo          , Ww          , Ww          , Ss          , Ss          
Gs^Fdw      , Gs^Fdf      , Gs^Fdw      , Gs^Fdf      , Gs^Fdf      , Gs^Fdf      , Gs^Fdw      , Gs^Fdf      , Ww          , Ww          , Wo          , Wo          , Ww          , Wo          , Ww          , Wo          , Ww          , Wo          , Ww          , Wo          , Wo          , Ww          , Ww^Bw|      , Ww          , Ww          , Ww          , Ww          , Ww          , Ww          , Ww          , Ww          , Ww          , Ww          , Wo          , Ww          , Wo          , Ww          , Wo          , Ww          , Ss          , Ss          , Gg          , Ss          , Ww          , Wo          , Wo          , Wo          , Wo          , Ss          , Ss          
Gs^Fdf      , Gs^Fdf      , Gs^Fdf      , Gs^Fdf      , Gs^Fdf      , Gs^Fdf      , Ww          , Ww          , Ww          , Wo          , Wo          , Wo          , Ss          , Ss          , Gg^Vh       , Gg          , Ww          , Ww          , Ww          , Ww          , Ww          , Ww          , Ww^Bw|      , Ww          , Gg          , Ww          , Gg^Vh       , Gg          , Re^Gvs      , Gg          , Gg          , Ww          , Ss          , Ww          , Ss          , Ww          , Ww          , Wo          , Wo          , Ww          , Ww          , Ss          , Ww          , Ww          , Wo          , Wo          , Wo          , Wo          , Wo          , Wo          
Gs^Fdf      , Gs^Fdw      , Gs^Fdf      , Gs^Fdw      , Ww          , Ww          , Wo          , Ww          , Wo          , Wo          , Ww          , Ss          , Ss          , Gg          , Gg          , Gg          , Gg          , Ww          , Gg          , Ww          , Ww          , Ww          , Rr          , Gg          , Re^Gvs      , Re^Gvs      , Re^Gvs      , Re^Gvs      , Re^Gvs      , Re^Gvs      , Re^Gvs      , Gg          , Gg          , Ss          , Ss          , Ss          , Ww          , Ww          , Wo          , Wo          , Wo          , Ww          , Wo          , Wo          , Wo          , Wo          , Wo          , Wo          , Wo          , Wo          
Gs^Fdf      , Gs^Fdw      , Gs^Fdw      , Ww          , Ww          , Wo          , Wo          , Wo          , Wo          , Ww          , Ww          , Ss          , Ss          , Gg          , Gs^Fdf      , Gg          , Gg          , Gg          , Gg          , Gg          , Gg          , Gg          , Rr          , Gg          , Re^Gvs      , Re^Gvs      , Re^Gvs      , Re^Gvs      , Re^Gvs      , Re^Gvs      , Re^Gvs      , Gg          , Ss          , Ss          , Ss          , Ss          , Ww          , Ww          , Wo          , Wo          , Wo          , Wo          , Wo          , Wo          , Wo          , Wo          , Wo          , Wo          , Wo          , Wo          
Gs^Fdw      , Gs^Fdf      , Gs^Fdf      , Ss          , Ww          , Wo          , Wo          , Wo          , Wo          , Ww          , Ww          , Ss          , Ss          , Gg          , Gs^Fdf      , Gg          , Gg          , Gg          , Gg          , Gg          , Gg          , Gg          , Rr          , Re^Gvs      , Re^Gvs      , Re^Gvs      , Re^Gvs      , Re^Gvs      , Re^Gvs      , Re^Gvs      , Re^Gvs      , Re^Gvs      , Ss          , Ss          , Ss          , Ss          , Ww          , Ww          , Wo          , Wo          , Wo          , Wo          , Wo          , Wo          , Wo          , Wo          , Wo          , Wo          , Wo          , Wo          
