border_size=1
usage=map

Rr          , Rr          , Rr          , Rr          , Rr          , Ch          , Gg          , Gg          , Hh          , Hh          , Hh          , Hh          , Hh          , Hh^Fp       , Hh^Fp       , Gg          , Gg          , Gg          , Ss          , Ss          , Ss          , Ww          , Ww          , Ww          , Ww          , Ww          , Wwr         , Wwr         , Wo          , Wwr         , Ww          , Ww          , Ss          , Ss          , Ss          , Ss          , Ss          , Hh^Fdw      , Hh          , Hh          , Hh          , Hh          , Hh^Fmw      , Hh^Fp       , Hh^Fp       , Hh^Fp       , Hh^Fp       
Rr          , Rr          , Rp^Vhc      , Rr          , Rr          , Ch          , Gg          , Gs^Fdf      , Hh^Fdf      , Gg          , Gg          , Hh          , Gg          , Hh^Fp       , Gg          , Gg          , Ss          , Ss          , Gg          , Ss          , Ds          , Ww          , Ww          , Ww          , Ww          , Ww          , Ww          , Wwr         , Wo          , Wwr         , Ww          , Ww          , Ww          , Ss          , Ss          , Ss          , Ss          , Ss          , Hh^Fdw      , Hh^Fdw      , Hh          , Hh^Fmw      , Hh^Fp       , Hh^Fp       , Hh^Fp       , Hh^Fp       , Gs^Fp       
Rr          , Rr          , Rr          , Rr          , Ch          , Ch          , Gg          , Gs^Fmw      , Gg          , Gg          , Gg          , Hh          , Gg          , Gg          , Re^Gvs      , Gg          , Ss          , Ss          , Gg          , Gg          , Gg          , Ds          , Ds          , Ww          , Ss          , Ww          , Ww          , Ww          , Wo          , Wo          , Ww          , Ww          , Ds          , Ds          , Ss          , Ss          , Gg          , Gg          , Gg          , Hh          , Gg          , Gg          , Gg          , Hh^Fp       , Gs^Fp       , Gs^Fp       , Gs^Fp       
Rr          , Rr          , Ch          , Ch          , Gg          , Gg          , Re          , Re          , Re          , Re          , Re          , Gg          , Re^Gvs      , Re^Gvs      , Re^Gvs      , Re^Gvs      , Gs^Fp       , Gg          , Re^Gvs      , Re^Gvs      , Gg^Vh       , Gg          , Gg          , Ss          , Ss          , Ss          , Ds          , Ww          , Wo          , Wo          , Ww          , Ww          , Ds          , Ss          , Gg          , Gg          , Gg          , Gg          , Gg          , Gg          , Re^Gvs      , Gg          , Gg          , Gs^Fp       , Gs^Fp       , Gs^Fp       , Gs^Fp       
Rr          , Rr          , 3 Kh        , Gs^Fdw      , Rp          , Rp          , Rp          , Rp          , Gg          , Re          , Re          , Re          , Re^Gvs      , Re^Gvs      , Re^Gvs      , Re^Gvs      , Re^Gvs      , Re^Gvs      , Gg          , Re^Gvs      , Gg          , Gg          , Gg          , Gg          , Ss          , Ss          , Ds          , Ww          , Wo          , Wo          , Ww          , Ds          , Ss          , Ss          , Gg          , Gg          , Gs^Fp       , Gg          , Gg          , Gg          , Gg^Vc       , Re^Gvs      , Re^Gvs      , Gg          , Gg          , Gs^Fp       , Gs^Fp       
Rp          , Rp          , Rp          , Rp          , Rp          , Rp          , Gg          , Gg          , Gg^Vh       , Gg          , Gg          , Re          , Re          , Re^Gvs      , Re^Gvs      , Re^Gvs      , Gg          , Gg          , Gg          , Gg          , Ss          , Gg          , Ss          , Ss          , Ds          , Ds          , Ww          , Ww          , Ww          , Ww          , Ww          , Ds          , Ss          , Gg          , Gg          , Gg          , Gs^Fp       , Gs^Fp       , Gs^Fp       , Gg          , Re^Gvs      , Re^Gvs      , Gg          , Gg          , Gg          , Gs^Fp       , Gs^Fp       
Rr          , Rr          , Ch          , Rp          , Gs^Fdw      , Gg          , Gg          , Re^Gvs      , Re^Gvs      , Re^Gvs      , Gg          , Re          , Re          , Gg          , Gg          , Gg          , Gg          , Gg          , Ds          , Ss          , Ww          , Ss          , Ss          , Ss          , Ww          , Ww          , Ww          , Ww          , Ww^Bw/      , Ww          , Ss          , Ss          , Gg          , Gg          , Gg          , Gg          , Gs^Fp       , Gs^Fmf      , Gs^Fp       , Gs^Fp       , Gg          , Gg          , Gg          , Gg          , Gg          , Gs^Fp       , Gs^Fp       
Ch          , Ch          , Gg          , Gs^Fdf      , Gs^Fdf      , Gg          , Gg          , Re^Gvs      , Gg          , Re^Gvs      , Gg          , Re          , Re          , Gg          , Gg          , Gg          , Ds          , Ds          , Ww          , Ww          , Ww          , Ww          , Ww          , Ww          , Ww          , Ww          , Gg          , Gs^Vht      , Ww          , Ss          , Gg          , Gg          , Gg          , Gg          , Gg          , Gg          , Gg          , Gg          , Gg          , Gg          , Gg          , Gg          , Gg          , Gg          , Gg          , Gg          , Gs^Fp       
Re^Gvs      , Re^Gvs      , Re^Gvs      , Re^Gvs      , Re^Gvs      , Gs^Fmf      , Gs^Fp       , Gg          , Ch          , Gg          , Gg          , Re          , Re          , Gg          , Gg          , Gg          , Ds          , Ww          , Ww          , Ww          , Ww          , Ww          , Ww          , Ww          , Ss          , Ss          , Re^Gvs      , Re^Gvs      , Ww          , Gg          , Re^Gvs      , Gg          , Gg          , Gg          , Gg          , Gg          , Gg          , Gg          , Gg          , Gg          , Gg          , Gg          , Gg          , Gg          , Gg          , Gg          , Gs^Fp       
Re^Gvs      , Re^Gvs      , Re^Gvs      , Re^Gvs      , Re^Gvs      , Re^Gvs      , Re^Gvs      , Gg          , Gg          , Gg          , Gg          , Gg          , Re          , Re          , Gg          , Ds          , Ww          , Ww          , Ww          , Ww          , Ww          , Ww          , Ww          , Ww          , Ss          , Re^Gvs      , Re^Gvs      , Re^Gvs      , Ww          , Re^Gvs      , Re^Gvs      , Gg          , Gg          , Gg          , Gg          , Gg          , Gg          , Gg          , Gg          , Gg          , Gg          , Gg          , Gg          , Gg          , Gg          , Gg          , Gg          
Re^Gvs      , Re^Gvs      , Gg^Wm       , Re^Gvs      , Re^Gvs      , Re^Gvs      , Re^Gvs      , Gg          , Gg          , Gg          , Gs^Fp       , Gg          , Gg          , Re          , Gg          , Ds          , Ww          , Ww          , Ds          , Ww          , Ds          , Ww          , Ww          , Ss          , Re^Gvs      , Re^Gvs      , Re^Gvs      , Re^Gvs      , Ww          , Re^Gvs      , Re^Gvs      , Gg          , Gg          , Gg          , Gg          , Gg          , Gg          , Gg          , Gs^Fp       , Gs^Fp       , Gs^Fp       , Gg          , Gg          , Gg          , Gg          , Gg          , Gg          
Re^Gvs      , Re^Gvs      , Re^Gvs      , Re^Gvs      , Re^Gvs      , Re^Gvs      , Gg^Vh       , Gg          , Gg          , Gg          , Gg          , Gg          , Gg          , Re          , Gg          , Ww          , Ww          , Ds          , Gg          , Ds          , Ds          , Ww          , Ww          , Ss          , Re^Gvs      , Re^Gvs      , Ss          , Ss          , Re^Gvs      , Re^Gvs      , Gg          , Gg          , Gg          , Gg          , Gg          , Gg          , Gs^Fp       , Gs^Fmf      , Gs^Fp       , Gs^Fmf      , Gg          , Gg          , Gg          , Gg          , Gg          , Gg          , Gg          
Re^Gvs      , Re^Gvs      , Re^Gvs      , Re^Gvs      , Re^Gvs      , Re^Gvs      , Re^Gvs      , Re^Gvs      , Gg          , Gg          , Gg          , Gg          , Ch          , Re          , Ww          , Ww          , Ds          , Ds          , Gg          , Gs^Fp       , Ds          , Ww          , Ww          , Ss          , Gg          , Re^Gvs      , Re^Gvs      , Re^Gvs      , Gg          , Gg          , Gg          , Gg          , Gg          , Gg          , Gs^Fp       , Gs^Fmf      , Gs^Fmf      , Gs^Fp       , Gs^Fmf      , Gs^Fp       , Gg          , Gg          , Gg          , Gg          , Gg          , Gg          , Gg          
Re^Gvs      , Re^Gvs      , Re^Gvs      , Re^Gvs      , Re^Gvs      , Re^Gvs      , Gg          , Gg          , Gg          , Gg          , Gg          , Gg          , Ww          , Ww^Bw|      , Ch          , Ww          , Gg          , Gg          , Gg          , Gg          , Ds          , Ww          , Ww          , Ss          , Gg          , Re^Gvs      , Gg          , Gg          , Gg          , Gg          , Gg          , Gg          , Gg          , Gg          , Gg          , Gs^Fp       , Gs^Fp       , Gg^Vc       , Gs^Fp       , Gs^Fp       , Gg          , Gg          , Gg          , Gg          , Ce          , Ce          , Gg          
Re^Gvs      , Re^Gvs      , Re^Gvs      , Re^Gvs      , Re^Gvs      , Gg          , Gg          , Gg          , Gg          , Gg          , Ww          , Ww          , Gg          , Re          , Gg          , Gg          , Gg          , Gg          , Gg          , Gg          , Gg          , Ww          , Ww          , Ss          , Ww          , Gg          , Gg          , Gg          , Gg          , Gg          , Gg          , Gg          , Gs^Fp       , Gg          , Gg          , Gg          , Re^Gvs      , Re^Gvs      , Re^Gvs      , Gg          , Gg          , Gg          , Gg          , Ce          , 1 Ke        , Ce          , Re          
Re^Gvs      , Re^Gvs      , Re^Gvs      , Re^Gvs      , Gg          , Gg          , Ch          , Gg          , Ww          , Ww          , Ww          , Ww          , Gg          , Re          , Re^Gvs      , Re^Gvs      , Re^Gvs      , Hh          , Gg          , Gg          , Gg          , Ww          , Ww          , Ww          , Ww          , Ww          , Gg          , Gg          , Gs^Fmf      , Gs^Fp       , Gg          , Gg          , Gg          , Gg          , Gg          , Gg          , Gg          , Re^Gvs      , Gg          , Gg          , Gg          , Gg          , Ce          , Ce          , Re          , Re          , Re          
Re^Gvs      , Re^Gvs      , Re^Gvs      , Gg          , Gg          , Gg          , Gg          , Gg          , Ww          , Ww          , Gg          , Gg          , Gg          , Re          , Re^Gvs      , Gg^Vh       , Re^Gvs      , Gg          , Gg          , Gg          , Re          , Ww          , Ww          , Ww          , Gg          , Gg          , Gg          , Gg          , Gs^Fdf      , Gs^Fmf      , Gg          , Gg          , Gg          , Gg          , Gg          , Gg          , Gg          , Gg          , Gg          , Gg          , Gg          , Gg          , Re          , Re          , Re          , Re          , Gg          
Re^Gvs      , Re^Gvs      , Re^Gvs      , Gg          , Gg          , Gg          , Gg          , Gg          , Ww          , Ww          , Gg          , Gg          , Re          , Gs^Fp       , Re^Gvs      , Re^Gvs      , Re          , Gg          , Re          , Re          , Ch          , Ww^Bw\      , Ww^Bw\      , Ww          , Ch          , Gg          , Re          , Gg          , Re          , Gg          , Re          , Gg          , Re          , Re          , Re          , Gg          , Re          , Gg          , Re          , Re          , Re          , Re          , Re          , Re          , Gg          , Gg          , Gg          
Re^Gvs      , Re^Gvs      , Gg^Vh       , Gg          , Gg          , Gg          , Gg          , Gg          , Ww          , Ww          , Gg          , Re          , Re          , Re          , Re          , Re          , Re          , Re          , Re          , Re          , Gg          , Ww          , Ww          , Ww^Bw\      , Re          , Re          , Re          , Re          , Re          , Re          , Re          , Re          , Re          , Re          , Re          , Re          , Re          , Re          , Re          , Re          , Gg          , Re          , Gg          , Gg          , Gg          , Gg          , Gg          
Re^Gvs      , Re^Gvs      , Re^Gvs      , Re^Gvs      , Gg          , Gg          , Gg          , Ww          , Ww          , Ww          , Gg          , Re          , Gg          , Re          , Gg          , Re          , Gg          , Re          , Gg          , Gg          , Gg          , Ww          , Ww          , Ww          , Ww          , Gg          , Gg          , Gg          , Gg          , Gg          , Gg          , Gs^Fp       , Gg          , Gg          , Gg          , Gg          , Gg          , Gg          , Gg          , Gg          , Gg          , Gg          , Gg          , Gg          , Gg          , Gg          , Gg          
Re^Gvs      , Re^Gvs      , Gg          , Gg          , Gg          , Gg          , Gg          , Ww          , Ww          , Ww          , Gg          , Gg          , Ww          , Gg          , Gg          , Gg          , Gg          , Gg          , Gg          , Gg          , Gg          , Ss          , Ww          , Ww          , Ww          , Gg          , Ss          , Gg          , Gg          , Gg          , Gg          , Gg          , Gg          , Gg          , Gg          , Gg          , Gg          , Gg          , Gg          , Gg          , Gg          , Gg          , Gg          , Gg          , Gg          , Gg          , Gg          
Re^Gvs      , Re^Gvs      , Gg          , Gg          , Gg          , Gg          , Gg          , Gg          , Ww          , Ww          , Ww          , Gg          , Ww          , Ww          , Gg          , Gg          , Hh^Fms      , Hh          , Hh          , Gg          , Gg          , Ss          , Ss          , Ww          , Ww          , Ss          , Ss          , Ss          , Ss          , Gg          , Ss^Vhs      , Gg          , Gg          , Gg          , Gg          , Ss          , Gg          , Ss          , Ss          , Gg          , Gg          , Gg          , Gg          , Gg          , Gg          , Gg          , Gg          
Gg          , Gg          , Gg          , Gg          , Gg          , Gg          , Gg          , Gg          , Gg          , Ww          , Ww          , Ww          , Ww          , Gg          , Gg          , Hh^Fms      , Hh^Fp       , Hh          , Hh          , Hh          , Gg          , Gg          , Ss          , Ww          , Ww          , Gg          , Gg          , Ss          , Ss          , Ss          , Ss          , Ss          , Ss          , Gg          , Gg          , Gg          , Ss          , Gg          , Ss          , Ss          , Ss          , Gg          , Gg          , Gg          , Gs^Fp       , Gg          , Gg          
Gg          , Gg          , Gg          , Gg          , Gg          , Gg          , Gg          , Gg          , Gg          , Gg          , Gg          , Ww          , Ww          , Ww          , Ww          , Gg          , Gs^Fp       , Hh^Fp       , Hh          , Hh          , Gg          , Gg          , Ss          , Ww          , Ww          , Gg          , Gg          , Gg          , Gs^Fp       , Ss          , Ss          , Ss          , Ss          , Ss          , Ss          , Gg          , Gg          , Gg          , Ss          , Ss          , Ss          , Ss          , Gg          , Gs^Fp       , Gs^Fp       , Gg          , Gg          
Gg          , Gg          , Gg          , Ch          , Gg          , Gg          , Gg          , Gg          , Gg          , Gg          , Gg          , Gg          , Ss          , Ww          , Ww          , Gg          , Gg          , Gs^Fp       , Gg          , Gg          , Gg          , Ss          , Ww          , Ww          , Ww          , Ww          , Ww          , Gs^Fms      , Gs^Fmf      , Gs^Fms      , Gs^Fms      , Ss          , Gg          , Ss          , Ss          , Gg          , Gg          , Gg          , Gg          , Ss          , Gg          , Ss          , Gg          , Gs^Fp       , Gs^Fp       , Gs^Fp       , Gg          
Gg          , Gg          , Gg          , Gg          , Gg          , Gg          , Gg          , Gg          , Gg          , Gg          , Gg          , Gg          , Ss          , Ww          , Ww          , Ww          , Ww          , Gg          , Gg          , Gg          , Gg          , Ss          , Ww          , Ww          , Ww          , Ww          , Ww          , Gg          , Gs^Fp       , Gs^Fp       , Gs^Fmf      , Gs^Fmf      , Gg          , Gg          , Gg          , Ss          , Gg          , Gg          , Gg          , Gg          , Gg          , Gg          , Gg          , Gg          , Gg          , Gg          , Gg          
Gg          , Gg          , Gg          , Gg          , Gg          , Gg          , Gg          , Gg          , Hh          , Hh          , Hh          , Gg          , Ss          , Ww          , Ww          , Ww          , Ww          , Ss          , Gg          , Gg          , Gg          , Ss          , Ss          , Ds          , Ww          , Ww          , Ww          , Gg          , Gg          , Gg          , Gg          , Gs^Fp       , Gg          , Gg          , Gg          , Gg          , Gg          , Gg          , Gg          , Gg          , Gg          , Gg          , Gg          , Gg          , Gg          , Gg          , Gg          
Gg          , Gg          , Gg          , Gg          , Gs^Fp       , Gs^Fp       , Gs^Fp       , Gg          , Gg          , Hh          , Gg          , Gg          , Ss          , Ww          , Ww          , Ss          , Ss          , Ss          , Gg          , Gg          , Gg          , Re          , Ss          , Ww          , Ww          , Ww          , Ww          , Gg          , Gg          , Gg          , Gg          , Gg          , Gg^Vc       , Re          , Gs^Fp       , Gs^Fms      , Ss          , Gg          , Gg          , Gg          , Gg          , Gg          , Gg          , Gg          , Ss          , Gg          , Gg          
Gg          , Gg          , Gg          , Gg          , Gg          , Gs^Fms      , Gs^Fds      , Gs^Fms      , Gs^Fp       , Gg          , Gg          , Ss          , Ww          , Ww          , Ww          , Ss          , Gg          , Gg          , Gg          , Gg          , Re          , Re          , Gg          , Ss          , Ww          , Ww          , Ss          , Gg          , Gg          , Gg          , Gg          , Re^Gvs      , Re^Gvs      , Re          , Gs^Fp       , Ss          , Ss          , Gs^Fp       , Gg          , Gg          , Gs^Fp       , Gg          , Gg          , Gg          , Ss          , Ss          , Ss          
Hh          , Gg          , Gg          , Gg          , Gg          , Gs^Fms      , Gs^Fms      , Gs^Fms      , Gg          , Gg          , Ss          , Ss          , Ww          , Ww          , Ss          , Ss          , Gg          , Gg          , Gg^Vc       , Gg          , Re          , Gg          , Gg          , Ss          , Ww          , Ww          , Ss          , Ss          , Ss          , Gg          , Gg          , Gg          , Re          , Re          , Gg          , Gs^Fms      , Ss          , Gs^Fp       , Gg          , Gg          , Gs^Fp       , Gs^Fmf      , Gs^Fmf      , Gg          , Gg          , Ss          , Ss          
Hh          , Hh          , Gg          , Gg          , Gg          , Gg          , Gg          , Gs^Fp       , Gg          , Gg          , Ss          , Ww          , Ww          , Ss          , Ss          , Ss          , Gg          , Gg          , Gg          , Gg          , Gg          , Gg          , Ww          , Ww          , Ww          , Ww          , Ww          , Ss          , Ss          , Ss          , Ss          , Gg          , Gg          , Gg          , Gg          , Gg          , Gs^Fp       , Gs^Fp       , Gg          , Gg          , Gg          , Gs^Fp       , Gs^Fp       , Gs^Fp       , Gs^Fms      , Ss          , Ss          
Hh          , Hh          , Gg          , Gg          , Gg          , Gg          , Gg^Vc       , Gg          , Gg          , Gg          , Ss          , Ww          , Ww          , Gs^Fms      , Gs^Fms      , Gs^Fms      , Gg          , Gg          , Gg          , Gg          , Ss          , Ww          , Ww          , Ww          , Ss          , Ww          , Ss          , Ss          , Ss          , Ss          , Ss          , Gg          , Gs^Fp       , Gg          , Gg          , Gg          , Gg          , Gs^Fp       , Gg          , Gg          , Gg          , Gg          , Gg          , Gs^Fmf      , Gs^Fms      , Ss          , Ss          
Hh          , Hh          , Hh          , Gg          , Gg          , Gg          , Gg          , Gg          , Gg          , Gg          , Ss          , Ww          , Ww          , Gs^Fms      , Gg          , Gg          , Gg          , Gg          , Gs^Fms      , Ss          , Ss          , Ww          , Ww          , Ss          , Ce          , Ce          , Ce          , Ss          , Ss          , Ss          , Ss          , Ss          , Ss          , Gs^Fp       , Gs^Fp       , Gg          , Gg          , Gg          , Gg          , Ss          , Ss          , Gg          , Gg          , Gg          , Gs^Fms      , Ss          , Ss          
Hh          , Hh          , Hh          , Hh          , Gg          , Gg          , Gg          , Gg          , Gg          , Gg          , Ss          , Ww          , Ss          , Ss          , Re          , Re          , Gg          , Gs^Fms      , Ss          , Ss          , Ss          , Ww          , Ww          , Ss          , Ce          , 2 Ke        , Ce          , Ss          , Gg          , Ss          , Ss          , Ss^Vhs      , Ss          , Gs^Fmf      , Gs^Fp       , Gg          , Gg          , Gg          , Gg          , Ss          , Gg          , Gs^Fp       , Gs^Fp       , Ss          , Gs^Fms      , Ss          , Ss          
Gs^Fms      , Hh          , Gg          , Gg          , Gs^Fp       , Gg          , Gs^Fp       , Gg          , Gs^Fp       , Gs^Fp       , Gs^Fp       , Ww          , Ww          , Ss          , Re          , Gg          , Gg          , Gs^Fms      , Ss          , Ss          , Ww          , Ww          , Ww          , Ss          , Ss          , Ce          , Re^Vct      , Gg          , Gs^Fms      , Gs^Fms      , Ss          , Ss          , Ss          , Ss          , Gs^Fp       , Gg          , Gg          , Gg          , Gg          , Gg          , Gg          , Gs^Fp       , Gs^Fp       , Ss          , Ss^Vhs      , Ss          , Ss          
Gs^Fms      , Gs^Fms      , Gs^Fp       , Gs^Fp       , Gs^Fms      , Gs^Fp       , Gs^Fms      , Gs^Fp       , Ss          , Gs^Fp       , Gs^Fp       , Ww          , Gs^Fp       , Ww          , Ss          , Re          , Re          , Ss          , Ss          , Ss          , Ww          , Ww          , Ww          , Ss          , Ss          , Ss          , Gg          , Gg          , Gs^Fp       , Gs^Fmf      , Ss          , Ss          , Ss          , Ss          , Gg          , Gg          , Gg          , Gg          , Gg          , Gg          , Ss          , Gs^Fp       , Gs^Fp       , Ss          , Ss          , Ss          , Ss          
Gg          , Gs^Fms      , Gs^Fms      , Gs^Fms      , Gs^Fms      , Gs^Fms      , Gs^Fms      , Ss          , Ss          , Ss          , Ss          , Ss          , Ww          , Ss          , Gg          , Gg          , Re          , Ss          , Ss          , Ss          , Ww          , Ww          , Ss          , Ss          , Ss          , Ss          , Gg          , Gg          , Gg          , Gs^Fp       , Gg          , Ss          , Ss          , Ss          , Gg          , Gg          , Gg          , Ss          , Ss          , Ss          , Gg          , Gs^Fp       , Gs^Fp       , Gs^Fp       , Ss          , Ss          , Ss          
