border_size=1
usage=map

Wo          , Wo          , Wo          , Wo          , Wo          , Wo          , Wo          , Wo          , Wo          , Wo          , Wo          , Wo          , Wo          , Wo          , Wo          , Wo          , Wo          , Wo          , Wo          , Wo          , Wo          , Wo          , Wo          , Wo          , Wo          , Wo          , Wo          , Wo          , Wo          , Wo          , Wo          , Wo          , Wo          , Wo          , Wo          , Wo          , Wo          , Wo          , Wo          , Wo          , Wo          , Wo          , Wo          , Wo          , Wo          , Wo          , Wo          , Wo          , Wo          , Wo          , Wo          , Wo          
Wo          , Wo          , Wo          , Wo          , Ww          , Wwr         , Wwr         , Wwr         , Ww          , Wo          , Wo          , Wo          , Wwr         , Wo          , Ww          , Wo          , Ww          , Wo          , Ww          , Wo          , Ww          , Wo          , Wo          , Wo          , Wo          , Wo          , Wwr         , Wo          , Ww          , Wo          , Wo          , Wo          , Wo          , Wo          , Ww          , Ww          , Ww          , Ww          , Ww          , Ww          , Ww          , Ww          , Ww          , Ww          , Ww          , Wo          , Ww          , Wo          , Wo          , Wo          , Wo          , Wo          
Wo          , Wo          , Ww          , Ww          , Ds          , Ds          , Ww          , Ds          , Ww          , Wo          , Wo          , Wwr         , Ds          , Ww          , Ds          , Ww          , Ds          , Ww          , Ds          , Ww          , Ds          , Ww          , Ww          , Wo          , Ww          , Ww          , Ds          , Ww          , Ww          , Ww          , Ww          , Wo          , Ww^Gyb      , Ww          , Ds          , Ds          , Ce          , Ds          , Ds          , Ds          , Ds          , Ww          , Ww          , Ww          , Ww          , Ww          , Wwr         , Ww          , Wo          , 2 Wo        , Wo          , Ww          
Wo          , Wo          , Ww          , Ww          , Ww          , Ww          , Ww          , Ww          , Ww          , Wo          , Wo          , Ww          , Ds          , Ds          , Gg          , Ds          , Gg          , Ds          , Gg          , Ds          , Gg          , Ds          , Ww          , Wo          , Ww          , Ww          , Ds          , Ds          , Ds          , Ds          , Ww          , Wo          , Wo          , Ww          , Ww^Bw/      , Ds^Bw/      , Ds          , Ds          , Gg          , Gg          , Gg          , Ds          , Ds          , Ww          , Ww          , Wwr         , Wwr         , Ww          , Ww          , Wo          , Wo          , Wo          
Wo          , Wo          , Ww          , Ww          , Ww          , Ww          , Ww          , Ww          , Ww          , Wo          , Wo          , Ww          , Ww          , Ds          , Ds          , Gg          , Gg          , Gg          , Gg          , Gg          , Ds          , Ds          , Ww          , Wo          , Ww          , Ds          , Gg          , Gg          , Gg          , Ds          , Ds          , Ww          , Ww          , Wo          , Wo          , Ww          , Ww          , Ds          , Ds          , Gg          , Gg          , Gg          , Gg          , Ds          , Ds          , Ww          , Ww          , Wwr         , Ww          , Wo          , Wo          , Ww          
Wo          , Wo          , Ww          , Ww          , Ww          , Ww          , Ww          , Ww          , Ww          , Ww          , Wo          , Wo          , Wo          , Ww          , Ds          , Ds          , Ds          , Ds          , Ds          , Ds          , Ww          , Ww          , Wo          , Wo          , Ww          , Ds          , Gg          , Gs^Fms      , Gs^Fds      , Gg          , Gg          , Ds          , Ds          , Ww          , Ww          , Wo          , Ww          , Ww          , Ds          , Ds          , Gg          , Gs^Vht      , Gs^Fms      , Gg          , Ds          , Ww          , Ww          , Ww          , Ww          , Wo          , Wo          , Ww          
Wo          , Wo          , Ww          , Ww          , Ds          , Ww^Syb      , Ds          , Ww          , Ds          , Ww          , Ww^Syb      , Ww          , Ww          , Wo          , Wo          , Ww          , Ww          , Ww          , Ww          , Ds          , Ww          , Wo          , Wo          , Ww          , Ds          , Ds          , Gg          , Gs^Fms      , Gs^Fms      , Gs^Fds      , Gg          , Gg          , Ds          , Ww          , Ww          , Wo          , Wo          , Ww          , Ww          , Ds          , Gg          , Gs          , Gs^Fms      , Gg          , Gg          , Ds          , Ds          , Ww          , Ww          , Wo          , Wo          , Ww          
Wo          , Wo          , Ww          , Ds          , Ds          , Gg          , Ce          , Ds          , Gg          , Ds          , Ds          , Ds          , Ww          , Ww          , Ww          , Wo          , Wo          , Wo          , Wo          , Ww          , Wo          , Wo          , Ww          , Ww          , Ds          , Gg          , Gs          , Gs          , Gs^Vht      , Gs          , Gs          , Gg          , Ds          , Ww          , Ww          , Ww          , Ww          , Wo          , Ww          , Ds          , Gg          , Ds          , Gs          , Gs          , Gs          , Gg          , Ds          , Ww          , Ww          , Wo          , Ww          , Ww          
Wo          , Wo          , Ww          , Ds          , Ds          , Ce          , 3 Ke        , Ce          , Gg          , Gg          , Gg          , Ds          , Ds          , Ww          , Ds          , Ww          , Ww          , Ww          , Ww          , Wo          , Wo          , Wwr         , Ww          , Ds          , Ds          , Gg          , Gg          , Gs          , Gs          , Gs          , Gs          , Gg          , Gg          , Ds          , Ds          , Ds          , Ds          , Ww          , Ds          , Ds          , Gg          , Gs^Fms      , Gg          , Ds          , Gg          , Gg          , Ds          , Ds          , Ww          , Wo          , Ww          , Ww          
Wo          , Wo          , Ww          , Ww^Syb      , Ds          , Ce          , Ce          , Ce          , Gg          , Gg          , Gg          , Gg          , Gg          , Ds          , Ds          , Ds          , Ww          , Ds          , Ww          , Ww          , Wo          , Wo          , Wo          , Ww          , Ww          , Ds          , Ds          , Gg          , Gg          , Gg          , Gg          , Gg          , Gg          , Gg          , Gg          , Gg          , Ds          , Ds          , Ds          , Gg          , Gg          , Gg          , Ds          , Ds          , Ds          , Ds          , Ww          , Ww          , Wo          , Wo          , Ww          , Ww          
Wo          , Wo          , Ww          , Ds          , Ds          , Gg          , Gg          , Gg          , Gg          , Gg          , Gg          , Gg          , Gg          , Ds          , Ww          , Ww          , Wo          , Ww          , Wo          , Wo          , Wo          , Wo          , Wo          , Ww          , Wo          , Ww          , Ww          , Ds          , Ds          , Ds          , Ds          , Ds          , Ds          , Ds          , Ds          , Ds          , Ds          , Ds          , Ds          , Ds          , Ds          , Ds          , Ww          , Ds          , Ww          , Ww          , Wo          , Wo          , Ww          , Ww          , Ww          , Ww          
Wo          , Ww          , Ww          , Ds          , Ds          , Gg          , Gg          , Gg          , Gg          , Gg          , Gg          , Ss          , Ss          , Ds          , Ww          , Ww          , Ww          , Wo          , Ww          , Wo          , Ww          , Ww          , Ww          , Wo          , Ww          , Wo          , Wo          , Ww          , Ww          , Ww          , Ww          , Ww          , Ww          , Ww          , Ww          , Ww          , Ww          , Ww          , Ww          , Ww          , Ww          , Ww          , Ww          , Ww          , Wo          , Wo          , Ww          , Ww          , Ww          , Ww          , Ww          , Ww          
Wo          , Ww          , Ww          , Ww          , Ww          , Ds          , Gg          , Gg          , Gs^Fms      , Gg          , Gg          , Gg          , Ss          , Ds          , Ww          , Ww          , Ds          , Ww          , Ds          , Ww          , Ss          , Ww          , Ss          , Ww          , Ww          , Ww          , Ww          , Wo          , Wo          , Wo          , Wo          , Wo          , Wo          , Wo          , Wo          , Wo          , Wo          , Wo          , Wo          , Wo          , Wo          , Wo          , Wo          , Wo          , Ww          , Ww          , Ss          , Ss          , Ss          , Ww          , Ww          , Ww          
Wo          , Wo          , Wwr         , Ww          , Ww          , Ds          , Ds          , Gg          , Gs^Fds      , Gs          , Gs^Fms      , Ss          , Ss          , Ww          , Ww          , Ds          , Gg          , Ds          , Gg          , Ss          , Ss          , Ss          , Ss          , Ss          , Ss          , Ww          , Ss          , Ww          , Ww          , Ww          , Ww          , Wo          , Wo          , Wo          , Ww          , Ww          , Ww          , Ww          , Ww          , Wo          , Ww          , Ww          , Ss          , Ww          , Ss          , Ss          , Gg          , Ss          , Ss          , Ww          , Ww          , Ww          
Wo          , Wo          , Wo          , Wwr         , Ww          , Ds          , Ds          , Gg          , Gs          , Gs          , Gs^Fms      , Ss          , Ss          , Ww          , Ww          , Ds          , Gg          , Gg          , Gg          , Gg          , Ss          , Ss          , Gg          , Gg          , Gg          , Ss          , Gg          , Ss          , Ss          , Ss          , Ss          , Ww          , Ww          , Wo          , Ww          , Ss          , Ss          , Ss          , Ww          , Wo          , Ww          , Ss          , Ss          , Ss          , Gg          , Gg          , Gg          , Gg          , Ss          , Ww          , Ww          , Ww          
Wo          , Wo          , Ww          , Wwr         , Ww          , Ww          , Ds          , Gg          , Gg          , Gs          , Gs^Fds      , Gs^Fms      , Gg          , Ss          , Ww          , Ds          , Ss          , Gg          , Gg          , Gg          , Gg          , Ss          , Gs          , Gg          , Gs          , Gg          , Gg          , Gg          , Gg          , Gg          , Ss          , Ww          , Ww          , Wo          , Ww          , Ss          , Ww          , Ww          , Wo          , Wo          , Ww          , Ww          , Ww          , Ss          , Ss          , Gg          , Re^Gvs      , Gg          , Gg          , Ss          , Ss          , Ss          
Wo          , Wo          , Ww          , Ww          , Ds          , Ds          , Gg          , Gg          , Gg          , Gs          , Gg          , Gg          , Ss          , Ss          , Ss          , Ww          , Ss          , Ss          , Ss          , Gg          , Gs          , Gs          , Gs^Fms      , Gs^Vht      , Gs^Fms      , Gs^Fms      , Gs          , Gg          , Gs          , Gg          , Gg          , Ss          , Ww          , Wo          , Wo          , Ww          , Wo          , Wo          , Chw         , Ww          , Ss          , Ss          , Ss          , Ww          , Ss          , Re^Gvs      , Re          , Re^Gvs      , Re^Gvs      , Gg          , Gg          , Gg          
Wo          , Ww          , Ww          , Ds          , Ds          , Ds          , Gg          , Gg          , Gs          , Gs          , Gs^Fms      , Gg          , Gg          , Gg          , Gg          , Ss          , Ss          , Gg          , Gg          , Gg          , Gs          , Gs^Fms      , Gs^Fms      , Gs^Fms      , Gs^Fms      , Gs^Fms      , Gs^Fms      , Gs          , Gs          , Gs          , Ss          , Ss          , Ss          , Ww          , Ww          , Wo          , Wo          , Chw         , Chw         , Ww          , Ss          , Gg          , Re^Gvs      , Ss          , Re          , Ss          , Gg          , Re          , Re          , Re          , Re          , Gg          
Wwr         , Ww          , Ww          , Ds          , Ds          , Gg          , Gg          , Gg          , Gs          , Gs^Fms      , Gs^Fds      , Gs^Fms      , Gs^Fms      , Gg          , Gg          , Gg          , Ss          , Ss          , Gg          , Gs          , Gs          , Gs^Fds      , Gs^Fds      , Gs^Fms      , Gs^Fms      , Gs^Fms      , Gs^Fms      , Gs          , Gs          , Gs          , Ss          , Ss          , Ss          , Ww          , Ww          , Wo          , Chw         , Khw         , Chs         , Ss          , Gg          , Gg          , Re          , Re          , Gg          , Gg          , Gs^Fds      , Gg          , Gg          , Gg          , Gg          , Re          
Wwr         , Wwr         , Ww          , Ds          , Gg          , Gg          , Gs          , Gs          , Gs          , Gs^Fms      , Gs^Fms      , Gs^Fds      , Gs^Fms      , Gs^Vht      , Gs          , Gg          , Ss          , Ss          , Gg          , Gg          , Gg          , Gs          , Gs          , Gs^Fms      , Gs^Fds      , Gs^Fms      , Gs^Fms      , Gs          , Gs          , Gs          , Ss          , Ss          , Ss          , Ww          , Ww          , Wo          , Ww          , Chw         , Ss          , Ss          , Gg          , Re^Gvs      , Re          , Gg          , Gs^Fds      , Gs^Fds      , Gs^Fds      , Gs^Fds      , Gs^Fms      , Gg          , Gg          , Gg          
Wwr         , Wwr         , Ww          , Ds          , Gg          , Gs          , Gs          , Gs          , Gg          , Gs          , Gs          , Gs^Fms      , Gs          , Gs          , Ss          , Ss          , Ss          , Ss          , Ss          , Gg          , Gg          , Gg          , Gs          , Gs          , Gs^Fds      , Gs^Fms      , Gs          , Gs          , Gs^Fds      , Ss          , Gs^Fds      , Gg          , Gg          , Ss          , Ss          , Ww          , Ww          , Ww          , Ss          , Gg          , Gg          , Re^Gvs      , Re          , Gg          , Gs^Fds      , Gs^Fds      , Gs^Fds      , Gs^Fds      , Hh^Fds      , Gs^Fms      , Gs^Fms      , Gg          
Wwr         , Wwr         , Ww          , Ds          , Gg          , Gs          , Gs          , Gg          , Gs^Fds      , Gg          , Gg          , Gs          , Gg          , Gg          , Ss          , Ss          , Ss          , Ss          , Ww          , Ss          , Gs^Fds      , Gg          , Gs          , Gs          , Gs          , Gs          , Gg          , Gs^Fds      , Gs^Fds      , Ss          , Gs^Fds      , Gs          , Gs          , Gg          , Gg          , Ss          , Ww          , Ss          , Ss          , Gg          , Gg          , Gg          , Re          , Gg          , Gg          , Gs^Fds      , Gs^Fds      , Hh^Fms      , Hh^Fms      , Hh^Fms      , Gs^Fms      , Gg          
Wwr         , Ww          , Ww          , Ds          , Gg          , Gs          , Gs          , Gg          , Gs^Fms      , Gs^Fds      , Gg          , Gg          , Gg          , Ss          , Gg          , Gg          , Ss          , Ww          , Wo          , Ww          , Ds          , Ds          , Gg          , Gs          , Gg          , Gg          , Ss          , Ss          , Ss          , Ss          , Gs^Fds      , Gs^Vht      , Gs          , Gs          , Gs          , Ss          , Ss          , Ww          , Gs          , Ss          , Ss          , Re^Gvs      , Re^Gvs      , Re^Gvs      , Gg          , Gg          , Gs^Fds      , Hh^Fds      , Hh^Fds      , Hh^Fms      , Gs^Fms      , Gg          
Wo          , Ww          , Ww          , Ds          , Gg          , Gs          , Gs          , Gg          , Gg          , Gg          , Gg          , Gg          , Gg          , Gg          , Ds          , Ds          , Ds          , Ww          , Ww          , Ww          , Ds          , Gg          , Gg          , Gg          , Gs          , Gg          , Ss          , Ss          , Ss          , Ss          , Gs^Fds      , Gs^Fds      , Gs^Fds      , Gs          , Gs          , Gs          , Ss          , Ww          , Ww          , Gs          , Ss          , Re^Gvs      , Re          , Re^Gvs      , Gg          , Gg          , Gg          , Gs^Fds      , Gs^Fms      , Gs^Fms      , Gs^Fms      , Gg          
Wo          , Ww          , Ww          , Ds          , Gg          , Gs^Vht      , Gs          , Gs          , Gg          , Gg          , Gg          , Gg          , Ds          , Ds          , Ds          , Ww          , Ww          , Ds          , Ds          , Ds          , Gg          , Gg          , Gg          , Gs          , Gg          , Gg          , Gg          , Gg          , Ss          , Gg          , Gs          , Gs^Fds      , Gs^Fds      , Gs^Fds      , Gs^Fds      , Gs^Fds      , Gs^Fds      , Ss          , Ww          , Ss          , Ss          , Gg          , Re          , Re^Gvs      , Gg^Vh       , Gg          , Gg          , Gg          , Gg          , Gg          , Ss          , Gg          
Wo          , Ww          , Ww          , Ds          , Gg          , Gs          , Gg          , Gs          , Gg          , Gg          , Gg          , Gg          , Ds          , Ww          , Ww          , Ww          , Ww          , Ww          , Ww          , Ds          , Gg          , Gg          , Gg          , Gs^Vht      , Gs^Fds      , Gg          , Gg          , Gg          , Ss          , Gg          , Gs          , Gs          , Gs          , Gs^Fds      , Gs^Fds      , Gs^Fds      , Gs^Fds      , Ss          , Ww          , Ss          , Re          , Gg          , Gg          , Re          , Re          , Re          , Gg          , Gg          , Gg          , Ss          , Ss          , Ss          
Wo          , Ww          , Ds          , Ds          , Gg          , Gg          , Gg          , Gg          , Gg          , Gg          , Ds          , Gg          , Ds          , Ww          , Ww          , Ww          , Ww          , Ww          , Ww          , Ds          , Ds          , Ds          , Ds          , Gs^Fds      , Ds          , Gg          , Ds          , Gg          , Gg          , Gg          , Gg          , Gs          , Gs          , Gs          , Gs          , Gs          , Gs          , Re          , Ww          , Ss          , Ww          , Ds          , Gg          , Gg          , Gg          , Gg          , Gg          , Gg          , Gg          , Ss          , Ss          , Ss          
Wo          , Ww          , Ds          , Ds          , Gg          , Gg          , Ds          , Ds          , Ds          , Ds          , Ww          , Ds          , Ww          , Ds          , Ww          , Ds          , Ww          , Wo          , Ww          , Ww          , Ww          , Ww          , Ww          , Ww          , Ww          , Ds          , Ww          , Ds          , Ds          , Gg          , Gg          , Gg          , Gg          , Gs          , Gg          , Gg          , Gg          , Ds          , Ww          , Ww          , Ds          , Ds          , Ds          , Gg          , Ds          , Gg          , Ds          , Gg          , Ds          , Ss          , Ss          , Ss          
Wo          , Ww          , Ww          , Ds          , Ds          , Ds          , Ww          , Ww^Bw|      , Ww          , Ww          , Ww          , Ww          , Ww          , Ww          , Ww          , Ww          , Ww          , Wo          , Wo          , Ww          , Ww          , Ww          , Ww          , Ww          , Ww          , Ww          , Ww          , Ww          , Ww          , Ds          , Ds          , Ds          , Ds          , Gg          , Ds          , Gg          , Ds          , Ds          , Ds          , Ww          , Ww          , Ds          , Ww          , Ds          , Ww          , Ds          , Ww          , Ds          , Ds          , Ds          , Ds          , Ww          
Wo          , Wo          , Ww          , Ww          , Ww          , Ww          , Ww          , Ww^Bw|      , Ww          , Ww          , Wwr         , Wwr         , Ww          , Ww          , Ww          , Ww          , Wo          , Wo          , Wo          , Wo          , Wwr         , Ww          , Ww          , Ww          , Ww          , Ww          , Ww          , Ww          , Ww          , Ww          , Ww          , Ww^Bw|      , Ww          , Ds          , Ww          , Ds          , Ww          , Ww          , Ww          , Ww          , Ww          , Ww          , Ww          , Ww          , Ww          , Ww          , Ww          , Ww          , Ww          , Ds          , Ww          , Ww          
Wo          , Wo          , Wo          , Ww          , Wwr         , Ww          , Ww          , Ww^Bw|      , Wo          , Wwr         , Wo          , Wwr         , Wo          , Ww          , Wo          , Wo          , Wwr         , Wo          , Wo          , Wo          , Wo          , Wo          , Wo          , Wo          , Wo          , Ww          , Wo          , Ww          , Ww          , Ds          , Ww          , Ww^Bw|      , Ww          , Ww          , Wo          , Ww          , Wo          , Wo          , Ww          , Ww          , Wo          , Wo          , Wo          , Ww          , Ww          , Ww          , Ww          , Ww          , Ww          , Ww          , Ww          , Ww          
Wo          , Wo          , Wo          , Wo          , Wo          , Wo          , Wwr         , Ww^Bw|      , Wo          , Wo          , Wo          , Wo          , Wo          , Wo          , Wo          , Wo          , Wo          , Wwr         , Wo          , Wo          , Wo          , Wo          , Wo          , Wo          , Wo          , Wo          , Wo          , Wo          , Wo          , Ww          , Ww          , Wo^Bw|      , Ds          , Ww          , Wo          , Wo          , Wo          , Wo          , Wo          , Wo          , Wo          , Wo          , Wo          , Wo          , Wo          , Wo          , Wo          , Wo          , Wo          , Wwr         , Wwr         , Wo          
Wo          , Wo          , Wo          , Wo          , Wo          , Wo          , Wo          , Wo^Bw\      , Wo^Bw\      , Wo          , Wo          , Wo          , Ce          , Wo          , Wo          , Wo          , Wo          , Wo          , Wo          , Wo          , Wo          , Wo          , Wo          , Wo          , Wo          , Wo          , Wo          , Wo          , Ce          , Wo          , Wo          , Wo^Bw|      , Ww          , Ww          , Wo          , Wo          , Wo          , Wo          , Wo          , Wo          , Wo          , Wo          , Wo          , Wo          , Ce          , Wo          , Wo          , Wo          , Wo          , Wwr         , Wwr         , Wo          
Wo          , Wo          , Wo          , Wo          , Wo          , Wo          , Wo          , Wo          , Ce          , Ce          , Ce          , Ce          , Kh          , Ce          , Ce          , Ce          , Ce          , Wo          , Wo          , Wo          , Wo          , Wo          , Wo          , Wo          , Ce          , Ce          , Ce          , Ce          , 1 Kh        , Ce          , Kh          , Ce          , Ce          , Ce          , Ce          , Wo          , Wo          , Wo          , Ce^Xo       , Ce^Xo       , Ce          , Ce          , Ce          , Ce          , Kh          , Ce          , Ce          , Ce          , Ce          , Wo          , Wo          , Wwr         
Wo          , Wo          , Wo          , Wo          , Wo          , Wo          , Wo          , Wo          , Ce          , Ce          , Ce          , Ce          , Ce          , Ce          , Ce          , Ce          , Ce          , Ce          , Ce          , Ce          , Ce          , Ce          , Ce          , Ce          , Ce          , Ce          , Ce          , Ce          , Ce          , Ce          , Ce          , Ce          , Ce          , Ce          , Ce          , Ce          , Ce          , Ce          , Ce          , Ce          , Ce          , Ce          , Ce          , Ce          , Ce          , Ce          , Ce          , Ce          , Ce          , Ce          , Wo          , Wo          
