border_size=1
usage=map

Xu          , Xu          , Xu          , Xu          , Xu          , Xu          , Xu          , Xu          , Xu          , Xu          , Xu          , Xu          , Xu          , Xu          , Xu          , Xu          , Xu          , Xu          , Xu          , Xu          , Xu          , Xu          , Xu          , Xu          , Xu          , Xu          , Xu          , Xu          , Xu          , Xu          , Xu          , Xu          , Xu          , Xu          , Xu          , Xu          , Xu          , Xu          , Xu          , Xu          , Xu          , Xu          , Xu          , Xu          , Xu          , Xu          
Xu          , Xu          , Xu          , Xu          , Xu          , Xu          , Xu          , Xu          , Xu          , Xu          , Xu          , Xu          , Xu          , Xu          , Xu          , Xu          , Xu          , Xu          , Xu          , Xu          , Xu          , Xu          , Xu          , Xu          , Xu          , Xu          , Xu          , Xu          , Xu          , Xu          , Xu          , Xu          , Xu          , Xu          , Xos         , Xos         , Xos         , Xu          , Uh          , Xu          , Xu          , Xu          , Xu          , Xu          , Xu          , Xu          
Xu          , Xu          , Xu          , Xu          , Xos         , Xu          , Xos         , Xos         , Xos         , Xu          , Xos         , Xu          , Xos         , Xu          , Xos         , Xu          , Xos         , Xos         , Xos         , Xu          , Xu          , Xu          , Uh          , Xos         , Xos         , Xos         , Xos         , Xos         , Xos         , Xos         , Xos         , Xos         , Xos         , Xos         , Uu          , Uu          , Uu          , Uh          , Uh          , Uh          , Xos         , Xu          , Xos         , Xu          , Xu          , Xu          
Xu          , Xu          , Xu          , Xu          , Uh          , Xos         , Uu          , Uu^Vu       , Uu          , Xos         , Uu          , Xos         , Xos         , Xos         , Xos         , Xos         , Uu          , Uu          , Uh          , Uh          , Uh          , Uh          , Uh          , Uh          , Uu          , Uu          , Uu          , Uu          , Uu          , Uu          , Uu          , Uu          , Ce          , Uu          , Uu          , Uu          , Uu^Vu       , Uu          , Uu          , Uh          , Uh          , Xos         , Xos         , Xu          , Xu          , Xu          
Xu          , Xu          , Uh          , Uh          , Uh          , Uh          , Uu          , Uu          , Uu          , Uu          , Uu          , Uu          , Xos         , Xos         , Uu          , Uu          , Uu          , Uh          , Uh          , Uh          , Uh          , Uh          , Xu          , Uh          , Uu          , Uu          , Uu          , Uh          , Uh          , Uu          , Uu^Vu       , Ce          , 1 Ke        , Uu^Vu       , Uu          , Uu          , Uu          , Uu          , Uu          , Uu          , Uu          , Uh          , Uh          , Xos         , Xu          , Xu          
Xu          , Xos         , Uh          , Uh          , Uh          , Uh          , Uh          , Uu          , Uu          , Uu          , Uu          , Uu          , Uu          , Xos         , Uu          , Uu          , Uu          , Uh          , Uh          , Uh          , Uh          , Uh          , Xu          , Uh          , Uh          , Uu          , Uu          , Uh          , Uu          , Uu          , Ur          , Ce          , Ce          , Ce          , Uu^Uf       , Ww          , Ww          , Ww          , Ww          , Uu          , Uu          , Uh          , Uh          , Xos         , Xu          , Xu          
Xu          , Xos         , Uu          , Uh          , Uu          , Uh          , Xu          , Uh          , Uh          , Uu          , Uh          , Uu          , Uu          , Xos         , Uu          , Uu          , Uu          , Uh          , Uh          , Uh          , Xu          , Xu          , Xu          , Uh          , Uh          , Uu          , Uu          , Uu          , Uu          , Ur          , Uu          , Uu^Uf       , Uu^Vu       , Uu^Uf       , Ww          , Wo          , Wo          , Ww          , Ww          , Uu          , Uu          , Uu          , Uh          , Xos         , Xu          , Xu          
Xu          , Xos         , Uu          , Uu          , Uu          , Uh          , Uh          , Xu          , Xu          , Uh          , Uh          , Uh          , Uu          , Uu          , Ur          , Ur          , Uu          , Uh          , Uh          , Uh          , Xu          , Xu          , Xu          , Uh          , Uh          , Uh          , Uu          , Uu          , Ur          , Ur          , Uu          , Uu^Uf       , Ww          , Ww          , Ww          , Wo          , Wo          , Wo          , Ww          , Uu          , Uu          , Uu          , Uh          , Xos         , Xu          , Xu          
Xu          , Xos         , Uu          , Uu          , Uu          , Uu          , Uu          , Uh          , Uh          , Uh          , Uh          , Uh          , Ur          , Ur          , Ur          , Uu          , Uu          , Uh          , Uh          , Uh          , Xu          , Xu          , Xu          , Uh          , Uh          , Uh          , Uu          , Ur          , Uu          , Uu          , Uu          , Uu          , Uu          , Ww          , Ww          , Ww          , Ww          , Wo          , Ww          , Uu          , Uu          , Uu          , Uh          , Xos         , Xu          , Xu          
Xos         , Xos         , Uu          , Uu          , Uu          , Uu          , Uu          , Uu          , Ur          , Uh          , Ur          , Ur          , Uu          , Uu          , Ur          , Ur          , Uu          , Uh          , Uh          , Uh          , Xos         , Xu          , Xos         , Uh          , Uh          , Uh          , Uu          , Ur          , Uu          , Xu          , Uu          , Uu          , Uu          , Uu^Uf       , Uu^Uf       , Ww          , Uu^Uf       , Ww          , Uu^Uf       , Uu          , Uu          , Uu          , Uh          , Xos         , Xu          , Xu          
Uu          , Uu          , Ce          , Uu          , Ce          , Uu          , Ur          , Ur          , Ur          , Ur          , Uh          , Uu          , Uu          , Uu          , Uu          , Ur          , Uu          , Uh          , Uh          , Uh          , Xos         , Xos         , Xos         , Uh          , Uh          , Uh          , Uu          , Ur          , Uu          , Xu          , Xu          , Uu          , Uu          , Uh          , Uu          , Uu^Uf       , Ur          , Uu          , Uu          , Uu          , Uu          , Uh          , Uh          , Xos         , Xu          , Xu          
Rr          , Uu          , Ce          , 3 Ke        , Ce          , Ur          , Uu          , Uu          , Uu          , Uh          , Xos         , Uh          , Uh          , Uu          , Uu          , Ur          , Ur          , Uh          , Uh          , Uh          , Xos         , Xos         , Xos         , Uh          , Uh          , Uh          , Uu          , Ur          , Uu          , Uh          , Uh          , Xu          , Uh          , Uu          , Uu          , Uu          , Ur          , Ur          , Uu          , Uu          , Uu          , Uh          , Xos         , Xos         , Xu          , Xu          
Rr          , Rr          , Rr          , Ce          , Ur          , Uu          , Uu          , Uu          , Uh          , Uh          , Xos         , Xos         , Uh          , Uu          , Uu          , Uu          , Uu          , Uu          , Xos         , Xos         , Xos         , Xos         , Xos         , Xos         , Xos         , Uu          , Uu          , Ur          , Uu          , Uu          , Uu          , Xu          , Xu          , Uh          , Uu          , Uu          , Ur          , Ur          , Uu          , Uu          , Uh          , Uh          , Xos         , Xu          , Xu          , Xu          
Rr          , Rr          , Rr          , Rr          , Rr          , Uu          , Uu          , Uh          , Xos         , Xos         , Xu          , Xos         , Xos         , Uh          , Uh          , Uu          , Uu          , Uu          , Xos         , Xos         , Uh          , Xos         , Xos         , Xos         , Xos         , Uu          , Ur          , Ur          , Uu          , Ww          , Uu          , Uh          , Xu          , Xu          , Uu          , Uu          , Uu          , Ur          , Uu          , Uh          , Xos         , Xos         , Xu          , Xu          , Xu          , Xu          
Uu          , Uu          , Uu          , Rr          , Rr          , Uu          , Uu          , Xos         , Xu          , Xu          , Xu          , Xu          , Xos         , Xos         , Uh          , Uu          , Uu          , Uu          , Uu          , Uh          , Uu^Eyt      , Uh          , Uh          , Rr          , Rr          , Ur          , Uu          , Uu          , Uu          , Ww          , Ww          , Uu          , Uu          , Xu          , Uu          , Uu          , Uu          , Uu          , Uu          , Uh          , Xos         , Xu          , Xu          , Xu          , Xu          , Xu          
Xos         , Uu          , Uu          , Rr          , Rr          , Uu          , Uu          , Xos         , Xu          , Xu          , Xos         , Xos         , Uh          , Uh          , Uu          , Uu          , Uu          , Uu          , Rr          , Uh          , Uu^Eyt      , Uu^Eyt      , Uh          , Uu^Eyt      , Rr          , Uu          , Uu          , Uu          , Uu          , Uu          , Ww          , Uu          , Uu          , Xu          , Uu          , Uu          , Uu^Vu       , Uu          , Ww          , Uh          , Uh          , Xos         , Xu          , Xu          , Xu          , Xu          
Xu          , Xos         , Uu          , Rr          , Rr          , Rr          , Uu          , Xos         , Xos         , Xos         , Uh          , Uh          , Uu          , Uu          , Uu          , Uu          , Rr          , Rr          , Rr          , Uu^Eyt      , Uu^Eyt      , Uu^Eyt      , Rr          , Rr          , Xos         , Xos         , Uu          , Uu          , Ww          , Uu          , Ww          , Uu          , Uu          , Xu          , Uu          , Uu          , Uu          , Uu          , Ww          , Uu          , Uh          , Xos         , Xos         , Xu          , Xu          , Xu          
Xu          , Xos         , Uu          , Uu          , Rr          , Rr          , Rr          , Uu          , Uu          , Xos         , Uh          , Uu          , Uu          , Uu          , Rr          , Rr          , Rr          , Rr          , Uu          , Rr          , Rr          , Rr          , Rr          , Rr          , Rr          , Xos         , Uu          , Uu          , Uu          , Ww          , Ww          , Uu          , Uu          , Xu          , Uu          , Uu          , Uu          , Uu          , Ww          , Ww          , Uu          , Uh          , Uh          , Xos         , Xu          , Xu          
Xu          , Xos         , Xos         , Uu          , Xos         , Rr          , Rr          , Rr          , Rr          , Uu          , Uu          , Uu          , Uu          , Uu          , Rr          , Rr          , Uu          , Uu          , Xos         , Rr          , Rr          , Rr          , Rr          , Rr          , Rr          , Uu          , Uu          , Uu          , Uh          , Ww          , Ww          , Uu          , Uu          , Xu          , Xu          , Xu          , Xu          , Uu          , Ww          , Ww          , Uu          , Uh          , Uh          , Xos         , Xu          , Xu          
Xu          , Xu          , Xu          , Xos         , Xu          , Xos         , Xos         , Rr          , Rr          , Rr          , Rr          , Uu          , Uu          , Rr          , Rr          , Rr          , Uu          , Uu          , Xos         , Xos         , Uh          , Rr          , Uh          , Uh          , Uu^Eyt      , Ur          , Uu          , Uh          , Uh          , Ww          , Ww          , Ww          , Uh          , Uu          , Uu          , Xu          , Xu          , Uu          , Ww          , Uu          , Uu          , Uu          , Uh          , Xos         , Xu          , Xu          
Xu          , Xu          , Xu          , Xu          , Xu          , Xu          , Xos         , Uu          , Uu          , Rr          , Rr          , Rr          , Rr          , Rr          , Rr          , Rr          , Uu          , Uu          , Uu          , Uh          , Uu^Eyt      , Uh          , Uh          , Uh          , Rr          , Ur          , Uu          , Uu          , Uu          , Ww          , Ww          , Ww          , Uh          , Uh          , Uu          , Uu          , Uu          , Uu          , Ww          , Uu          , Uu          , Uu          , Uh          , Xos         , Xu          , Xu          
Xu          , Xu          , Xu          , Xu          , Uh          , Xu          , Xu          , Xos         , Xos         , Uu          , Ww          , Rr          , Rr          , Rr          , Rr          , Rr          , Rr          , Uu          , Uu          , Uh          , Uu^Eyt      , Uu^Eyt      , Uu^Eyt      , Rr          , Rr          , Uu          , Uu          , Uu          , Ww          , Ww          , Ww          , Ww          , Ww          , Ww          , Uu          , Uu          , Uu          , Uu          , Ww          , Uu          , Uu          , Uu          , Uh          , Xos         , Xu          , Xu          
Xu          , Xu          , Xu          , Uh          , Uh          , Uh          , Uh          , Xu          , Uu          , Uu          , Ww          , Ww          , Ww          , Rr          , Ur          , Rr          , Rr          , Rr          , Rr          , Rr          , Rr          , Uu^Eyt      , Rr          , Rr          , Rr          , Uu          , Uu          , Uu          , Ww          , Ww          , Ww          , Ww          , Uu          , Uu          , Uu          , Uu          , Ww          , Ww          , Uu          , Uu          , Uu          , Uu          , Uh          , Xos         , Xu          , Xu          
Xu          , Xu          , Xu          , Uh          , Uu          , Uu          , Uu          , Uh          , Ww          , Ww^Syb      , Ww          , Ww          , Ww          , Ww          , Uu          , Ur          , Ur          , Rr          , Rr          , Rr          , Rr          , Rr          , Rr          , Rr          , Xos         , Xos         , Uu          , Uu          , Uu          , Ww          , Ww          , Ww          , Uu          , Uu          , Uu          , Uu          , Ww          , Uu          , Uu          , Uu          , Uu          , Uh          , Uh          , Xos         , Xu          , Xu          
Xu          , Xu          , Xu          , Uh          , Uu          , Uu^Vu       , Uu          , Uu          , Ww          , Wo          , Ww          , Ww          , Uh          , Uu          , Uu          , Uu          , Ur          , Ur          , Rr          , Rr          , Uu^Eyt      , Rr          , Rr          , Rr          , Rr          , Xos         , Uu          , Uu          , Uu          , Ww          , Ww          , Ww          , Uu          , Uu          , Uu          , Uu          , Ww          , Uu          , Uu          , Uu          , Uh          , Uh          , Xos         , Xos         , Xu          , Xu          
Xu          , Xu          , Xu          , Uh          , Uh          , Uu          , Uu          , Uu          , Ww          , Ww          , Uu          , Uu          , Uh          , Uh          , Uu          , Ur          , Ur          , Rr          , Rr          , Uh          , Uh          , Uh          , Rr          , Rr          , Rr          , Uu          , Uu          , Uu          , Uu          , Ww          , Ww          , Ww          , Uu          , Uu          , Uu          , Ww          , Ww          , Uu          , Uu          , Uh          , Xos         , Xos         , Xu          , Xu          , Xu          , Xu          
Xu          , Xu          , Xu          , Xu          , Uh          , Uu          , Uu          , Uu          , Ww          , Ww          , Uu          , Uu          , Uh          , Uh          , Uu          , Uu          , Rr          , Rr          , Rr          , Uu^Eyt      , Uh          , Uu^Eyt      , Rr          , Rr          , Uu^Eyt      , Uh          , Uu          , Uu          , Uu          , Ww          , Wo          , Ww          , Uu          , Uu          , Uu          , Ww          , Uu          , Uu          , Uu          , Uh          , Xos         , Xu          , Xu          , Xu          , Xu          , Xu          
Xu          , Xu          , Xu          , Xu          , Uh          , Uh          , Uu          , Uu          , Ww          , Ww          , Uu          , Uu          , Uu          , Uu          , Uu          , Uu          , Rr          , Rr          , Rr          , Uh          , Uu^Eyt      , Uh          , Rr          , Rr          , Rr          , Uh          , Uu          , Uu          , Ww          , Ww          , Ww          , Ww          , Uu          , Uu          , Uu          , Ww          , Uu          , Uu          , Uu          , Uh          , Xos         , Xu          , Xos         , Xu          , Xu          , Xu          
Xu          , Xu          , Xu          , Xu          , Uh          , Uh          , Uu          , Ww          , Wo          , Ww          , Uu          , Uu          , Ww          , Uu          , Uu          , Xos         , Xos         , Rr          , Rr          , Uu^Eyt      , Uu^Eyt      , Uu^Eyt      , Rr          , Rr          , Rr          , Rr          , Uu          , Uu          , Ww          , Ww          , Ww          , Ww          , Uu          , Uu          , Uu          , Ww          , Uu          , Uu          , Uu          , Uh          , Uh          , Xos         , Xos         , Xos         , Xu          , Xu          
Xu          , Xu          , Xu          , Uh          , Uh          , Uu          , Uu          , Ww          , Wo          , Ww          , Ww          , Uu          , Ww          , Uu          , Uu          , Xos         , Ur          , Ur          , Uu          , Rr          , Ww          , Rr          , Uu          , Uu          , Uu          , Uu          , Uu          , Uu          , Ww          , Ww          , Wo          , Ww          , Uu          , Uu          , Uu          , Ww          , Uu          , Uu          , Uu          , Uu          , Uu          , Uh          , Uh          , Xos         , Xu          , Xu          
Xu          , Xu          , Xu          , Uh          , Uh          , Uu          , Uu          , Ww          , Wo          , Ww          , Ww          , Ww          , Uu          , Uu          , Uu          , Uu          , Uu          , Ur          , Uu          , Ww          , Ww          , Ww          , Uu          , Uu          , Uu          , Uu          , Uu          , Uu          , Ww          , Ww          , Wo          , Ww          , Ww          , Uu          , Ww          , Ww          , Uu          , Uu          , Uu          , Uu          , Uu          , Uh          , Uh          , Xos         , Xos         , Xu          
Xu          , Xu          , Xu          , Xu          , Uh          , Uu          , Uu          , Ww          , Ww          , Wo          , Ww          , Uu          , Ww          , Uu          , Uu          , Uu          , Uu          , Uu          , Uu          , Ww          , Ww          , Ww          , Uu          , Uu          , Uu          , Uu          , Uu          , Uu          , Ww          , Ww          , Ww          , Ww          , Ww          , Ww          , Ww          , Ww          , Uu          , Uu          , Uu          , Uu          , Uu          , Uu          , Uh          , Xos         , Xu          , Xu          
Xu          , Xu          , Xu          , Xu          , Uh          , Uu          , Uu          , Uu          , Ww          , Ww          , Ww          , Uu          , Uu          , Uu          , Uu          , Uu          , Ww          , Ww^Syb      , Ww          , Ww          , Wo          , Ww          , Ww          , Ww          , Ww          , Ww^Syb      , Ww          , Ww          , Wo          , Wo          , Ww          , Ww          , Ww          , Ww          , Ww          , Ww          , Uu          , Uu          , Ww          , Ww          , Uu          , Uu          , Uh          , Xos         , Xu          , Xu          
Xu          , Xu          , Xu          , Uh          , Uu          , Uu          , Uu          , Uu          , Ww          , Ww          , Ww          , Uu          , Ww          , Uu          , Ww          , Ww          , Ww          , Ww          , Ww          , Wo          , Wo          , Wo          , Wo          , Ww          , Ww          , Ww          , Ww          , Ww          , Wo          , Wo          , Ww          , Wwr         , Ww          , Ww          , Ww          , Uu          , Uu          , Uu          , Ww          , Uu          , Uu          , Uu          , Uh          , Xos         , Xu          , Xu          
Xu          , Xu          , Xu          , Uu          , Uu          , Uu          , Ww          , Uu          , Ww          , Ww          , Ww          , Ww          , Ww          , Ww          , Ww          , Ww          , Ww          , Ww          , Ww          , Wo          , Wo          , Wo          , Wo          , Ww          , Wwr         , Ww          , Wo          , Wo          , Wo          , Ww          , Ww          , Ww          , Ww          , Ww          , Ww          , Uu          , Ww          , Ww          , Uu          , Uu          , Uu          , Uu          , Uh          , Xos         , Xu          , Xu          
Xu          , Xu          , Uu          , Uu          , Ww          , Ww          , Ww          , Ww          , Ww          , Ww          , Ww          , Wwr         , Ww          , Ww          , Ww          , Ww          , Wwr         , Ww          , Wo          , Wwr         , Wo          , Wo          , Wo          , Wo          , Wo          , Wo          , Wo          , Wo          , Wo          , Ww          , Ww          , Ww          , Wwr         , Ww          , Ww          , Ww          , Ww          , Uu          , Uu          , Uu          , Uu          , Uu          , Uh          , Xos         , Xu          , Xu          
Xu          , Xu          , Xu          , Ww          , Ww          , Ww          , Ww          , Ww          , Wwr         , Ww          , Ww^Vm       , Ww          , Wwr         , Ww          , Wwr         , Ww          , Wo          , Wo          , Wo          , Wo          , Wo          , Wo          , Wo          , Wo          , Wo          , Wo          , Wo          , Wo          , Ww^Vm       , Ww          , Wwr         , Ww          , Ww          , Ww          , Ww          , Ww          , Ww          , Ww          , Ww          , Uu          , Uu          , Uu          , Uh          , Xos         , Xu          , Xu          
Xu          , Xu          , Xu          , Ww          , Ww          , Wwr         , Wo          , Wo          , Wo          , Wo          , Wo          , Wo          , Wo          , Wo          , Wo          , Wo          , Wo          , Wo          , Wo          , Wo          , Wo          , Wo          , Wo          , Wo          , Wo          , Wo          , Wo          , Wo          , Wo          , Wo          , Wo          , Wo          , Wo          , Chw         , Chw         , Chw         , Chw         , Ww          , Ww          , Uu          , Uu          , Uu          , Uh          , Xos         , Xu          , Xu          
Xu          , Xu          , Ww          , Ww          , Wo          , Wo          , Wo          , Wo          , Wo          , Wo          , Wo          , Wo          , Wo          , Wo          , Wo          , Wo          , Wo          , Wo          , Wo          , Wo          , Wo          , Wo          , Wo          , Wo          , Wo          , Wo          , Wo          , Wo          , Wo          , Wo          , Wo          , Wo          , Wo          , Wo          , Wo          , 2 Khw       , Chw         , Ww          , Ww          , Ww          , Uu          , Uu          , Xos         , Xos         , Xu          , Xu          
Uu          , Uu          , Ww          , Ww          , Wo          , Wo          , Wo          , Wo          , Wo          , Wo          , Wo          , Wo          , Wo          , Wo          , Wo          , Wo          , Wo          , Wo          , Wo          , Wo          , Wo          , Wo          , Wo          , Wo          , Wo          , Wo          , Wo          , Wo          , Wo          , Wo          , Wo          , Wo          , Wo          , Wo          , Wo          , Wo          , Ww          , Ww          , Ww          , Ww          , Uu          , Uu          , Xos         , Xos         , Xos         , Xu          
