border_size=1
usage=map

Uu          , Uu          , Uu          , Uu          , Uu          , Uu          , Uu          , Uu          , Uu          , Uu          , Uu          , Uu          , Uu          , Uu          , Ds          , Ds          , Syt         , Syt         , Syt         , Syt         , Ds          , Ds          , Uu          , Ur          , Uu          , Qxu         , Qxu         , Qxu         , Uh          , Ds          , Ds          , Syt         , Syt         , Syt         , Syt         , Syt         , Syt         , Syt         , Syt         , Syt         , Ds          , Ds          , Ds          , Ds          , Ds          , Ds          
Uu          , Uu          , Uu          , Uu          , Uu          , Uu          , Uu          , Uu          , Uu          , Uu          , Uu          , Uu          , Uu          , Uu          , Re          , Ds          , Ds          , Syt         , Syt         , Syt         , Ds          , Ds          , Uu          , Ur          , Uu          , Qxu         , Qxu         , Qxu         , Qxu         , Uh          , Uh          , Ds          , Ds          , Ds          , Ds          , Syt         , Ds          , Syt         , Syt         , Syt         , Ds          , Ds          , Ds          , Ds          , Ds          , Ds          
Uu          , Uu          , Uu^Vu       , Uu          , Uu          , Uu          , Uh          , Uh          , Uh          , Uu          , Uu          , Uu          , Uu          , Uu^Vu       , Uu          , Re          , Ds          , Ds          , Syt         , Syt         , Ds          , Ds          , Uu          , Ur          , Uu          , Qxu         , Qxu         , Qxu         , Qxu         , Uh          , Qxu         , Ds          , Ds          , Ds          , Ds          , Ds          , Ds          , Ds          , Ds          , Syt         , Ds          , Ds          , Ds          , Ds          , Ds          , Ds          
Uu          , Uu          , Uu          , Uu          , Uu          , Uu          , Re          , Uh          , Uh          , Uh          , 4 Kud       , Uu          , Uu          , Uu          , Uu          , Re          , Re          , Ds          , Ds          , Ds          , Ds          , Uu          , Uu          , Ur          , Uu          , Uu          , Qxu         , Qxu         , Qxu         , Qxu         , Qxu         , Qxu         , Qxu         , Uh          , Uh          , Ds          , Ds          , Ds          , Ds          , Ds          , Ds          , Ds          , Ds          , Ds          , Ds          , Ds          
Uu          , Uu          , Uu          , Uu          , Re          , Re          , Ds          , Re          , Uh          , Cud         , Cud         , Cud         , Cud         , Uu          , Uu          , Uu          , Re          , Ds          , Ds          , Ds          , Uu          , Uu          , Uu          , Ur          , Uu          , Uu          , Qxu         , Qxu         , Qxu         , Qxu         , Qxu         , Qxu         , Qxu         , Qxu         , Qxu         , Qxu         , Qxu         , Ds          , Uh          , Ds          , Ds          , Ds          , Ds          , Ds          , Ds          , Ds          
Uu          , Uu          , Uu          , Re          , Ds          , Ds          , Syt         , Ds          , Ds          , Uh          , Re          , Qxu         , Qxu         , Cud         , Cud         , Uu          , Ds          , Ds          , Uh          , Uu          , Uu          , Uu^Vu       , Ur          , Ur          , Uu          , Qxu         , Qxu         , Qxu         , Qxu         , Qxu         , Qxu         , Qxu         , Qxu         , Qxu         , Qxu         , Qxu         , Qxu         , Qxu         , Qxu         , Uh          , Uh          , Ds          , Qxu         , Ds          , Ds          , Qxu         
Uu          , Uu          , Uu          , Re          , Ds          , Syt         , Syt         , Syt         , Ds          , Ds          , Ds          , Re          , Re          , Qxu         , Uu          , Uu          , Ds          , Ds          , Uh          , Uu          , Uu          , Ur          , Ur          , Uu          , Qxu         , Qxu         , Qxu         , Qxu         , Qxu         , Qxu         , Qxu         , Qxu         , Qxu         , Qxu         , Qxu         , Qxu         , Qxu         , Qxu         , Qxu         , Uh          , Qxu         , Qxu         , Qxu         , Qxu         , Qxu         , Qxu         
Uu          , Uu          , Uu          , Re          , Ds          , Syt         , Syt         , Syt         , Ds          , Ds          , Re          , Ds          , Re          , Qxu         , Qxu         , Uu          , Uu          , Uh          , Uu          , Uu          , Re          , Ur          , Re          , Qxu         , Qxu         , Qxu         , Qxu         , Qxu         , Qxu         , Qxu         , Qxu         , Qxu         , Qxu         , Qxu         , Qxu         , Qxu         , Qxu         , Qxu         , Qxu         , Qxu         , Qxu         , Qxu         , Qxu         , Qxu         , Qxu         , Qxu         
Uu          , Uu          , Uu          , Re          , Ds          , Ds          , Ds          , Ds          , Ds          , Uh          , Re          , Re          , Re          , Qxu         , Qxu         , Uu          , Uu          , Uu          , Ds          , Ds          , Re          , Ds          , Ds          , Re          , Re          , Qxu         , Qxu         , Qxu         , Qxu         , Qxu         , Re          , Uu          , Uu          , Qxu         , Qxu         , Qxu         , Qxu         , Qxu         , Qxu         , Qxu         , Qxu         , Qxu         , Qxu         , Qxu         , Qxu         , Qxu         
Uu          , Uu          , Uu          , Re          , Re          , Ds          , Ds          , Ds          , Ds          , Re          , Ds          , Re          , Re          , Re          , Re          , Qxu         , Ds          , Ds          , Ds          , Ds          , Ds          , Ds          , Ds          , Ds          , Ds          , Re          , Re          , Qxu         , Re          , Re          , Ds          , Uh          , Re          , Uu          , Qxu         , Qxu         , Qxu         , Qxu         , Qxu         , Qxu         , Qxu         , Qxu         , Qxu         , Qxu         , Qxu         , Qxu         
Uu          , Uu          , Uu          , Re          , Uh          , Ds          , Uh          , Uh          , Qxu         , Ds          , Ds          , Ds          , Ds          , Ds          , Ds          , Ds          , Ds          , Ds          , Re          , Ds          , Ds          , Re          , Re          , Ds          , Ds          , Re          , Re          , Re          , Re          , Ds          , Ds          , Ds          , Ds          , Re          , Uu          , Qxu         , Qxu         , Qxu         , Qxu         , Qxu         , Qxu         , Qxu         , Qxu         , Qxu         , Qxu         , Qxu         
Uu          , Uu          , Uu          , Uh          , Qxu         , Uh          , Qxu         , Qxu         , Qxu         , Qxu         , Re          , Ds          , Ds          , Ds          , Re          , Ds          , Ds          , Ds          , Ds          , Re          , Ds          , Ds          , Re          , Re          , Re          , Ds          , Re          , Re          , Ds          , Ds          , Syt         , Syt         , Ds          , Re          , Uu          , Qxu         , Qxu         , Qxu         , Qxu         , Qxu         , Qxu         , Qxu         , Qxu         , Qxu         , Qxu         , Qxu         
Uu          , Uu          , Uu          , Uu          , Uu          , Qxu         , Qxu         , Qxu         , Qxu         , Qxu         , Re          , Re          , Re          , Ds          , Re          , Ds          , Ds          , Ds          , Ds          , Ds          , Re          , Ds          , Ds          , Re          , Re          , Re          , Ur          , Re          , Uh          , Ds          , Syt         , Syt         , Ds          , Re          , Uu          , Qxu         , Qxu         , Qxu         , Qxu         , Qxu         , Qxu         , Qxu         , Qxu         , Qxu         , Qxu         , Qxu         
Uu          , Uu          , Uu          , Uu          , Uu          , Uu          , Qxu         , Qxu         , Qxu         , Qxu         , Re          , Re          , Ds          , Re          , Re          , Ds          , Ds          , Ds          , Ds          , Qxu         , Qxu         , Re          , Re          , Re          , Ur          , Ur          , Qxu         , Ur          , Re          , Ds          , Ds          , Ds          , Uh          , Re          , Uu          , Qxu         , Qxu         , Qxu         , Qxu         , Qxu         , Qxu         , Qxu         , Qxu         , Qxu         , Qxu         , Qxu         
Uu          , Uu          , Uu          , Uu          , Uu          , Uu          , Uu          , Uu          , Uu          , Qxu         , Qxu         , Ds          , Ds          , Ds          , Ds          , Ds          , Ds          , Ds          , Re          , Re          , Uh          , Re          , Re          , Uu          , Ur          , Qxu         , Qxu         , Ur          , Ur          , Re          , Re          , Ds          , Re          , Uu          , Qxu         , Qxu         , Qxu         , Qxu         , Qxu         , Qxu         , Qxu         , Qxu         , Qxu         , Qxu         , Qxu         , Qxu         
Uu          , Uu          , Re          , Re          , Re          , Uu          , Uu          , Uu          , Uu          , Uu          , Qxu         , Qxu         , Qxu         , Ds          , Qxu         , Ds          , Ds          , Re          , Uu          , Uh          , Ds          , Ds          , Ds          , Re          , Re          , Qxu         , Uu          , Uu          , Qxu         , Ur          , Ur          , Re          , Uu          , Qxu         , Qxu         , Qxu         , Qxu         , Qxu         , Qxu         , Qxu         , Qxu         , Qxu         , Qxu         , Qxu         , Qxu         , Qxu         
Uu          , Uu          , Uu          , Re          , Ds          , Re          , Re          , Uu          , Uu          , Uu          , Qxu         , Qxu         , Qxu         , Qxu         , Qxu         , Ds          , Qxu         , Re          , Ur          , Ds          , Syt         , Syt         , Syt         , Ds          , Re          , Uu          , Uu          , Uu          , Uu          , Qxu         , Uu          , Ur          , Qxu         , Qxu         , Qxu         , Qxu         , Qxu         , Qxu         , Qxu         , Qxu         , Qxu         , Qxu         , Qxu         , Qxu         , Qxu         , Qxu         
Uu          , Uu          , Uu          , Re          , Ds          , Ds          , Ds          , Re          , Re          , Qxu         , Qxu         , Qxu         , Qxu         , Qxu         , Qxu         , Qxu         , Qxu         , Uu          , Ur          , Ds          , Ds          , Syt         , Ds          , Ds          , Re          , Uu          , Qxu         , Qxu         , Qxu         , Uu          , Qxu         , Ur          , Qxu         , Qxu         , Qxu         , Qxu         , Qxu         , Qxu         , Qxu         , Qxu         , Qxu         , Qxu         , Qxu         , Qxu         , Qxu         , Qxu         
Uu          , Uu          , Uu          , Re          , Re          , Ds          , Ds          , Ds          , Re          , Re          , Re          , Qxu         , Re          , Qxu         , Qxu         , Qxu         , Qxu         , Uu          , Ur          , Re          , Uh          , Uh          , Re          , Re          , Uu          , Uu          , Qxu         , Qxu         , Qxu         , Qxu         , Qxu         , Ur          , Ur          , Qxu         , Uu          , Qxu         , Qxu         , Qxu         , Qxu         , Qxu         , Qxu         , Qxu         , Qxu         , Qxu         , Qxu         , Qxu         
Uu          , Uu          , Uu          , Uu          , Uu          , Re          , Re          , Re          , Ds          , Ds          , Re          , Re          , Re          , Qxu         , Qxu         , Qxu         , Qxu         , Qxu         , Qxu         , Ur          , Qxu         , Uu          , Qxu         , Ur          , Qxu         , Qxu         , Qxu         , Qxu         , Re          , Qxu         , Re          , Uu          , Uh          , Ur          , Ur          , Uu          , Qxu         , Qxu         , Qxu         , Qxu         , Qxu         , Qxu         , Qxu         , Qxu         , Qxu         , Qxu         
Uu          , Uu          , Uu          , Uu          , Uu          , Uu          , Qxu         , Re          , Re          , Ds          , Ds          , Re          , Ds          , Re          , Re          , Qxu         , Qxu         , Qxu         , Qxu         , Ur          , Ur          , Qxu         , Ur          , Ur          , Qxu         , Qxu         , Re          , Re          , Ds          , Re          , Re          , Uu          , Uu          , Uu          , Uu          , Ur          , Uu          , Qxu         , Qxu         , Qxu         , Qxu         , Qxu         , Qxu         , Qxu         , Qxu         , Qxu         
Uu          , Uu          , Uu          , Uu          , Qxu         , Qxu         , Qxu         , Re          , Qxu         , Re          , Re          , Ds          , Ds          , Ds          , Re          , Qxu         , Re          , Qxu         , Qxu         , Ur          , Qxu         , Ur          , Qxu         , Qxu         , Qxu         , Qxu         , Re          , Ds          , Ds          , Ds          , Re          , Re          , Uu          , Qxu         , Qxu         , Ur          , Uu          , Qxu         , Qxu         , Qxu         , Qxu         , Qxu         , Qxu         , Qxu         , Qxu         , Qxu         
Qxu         , Qxu         , Qxu         , Qxu         , Qxu         , Qxu         , Qxu         , Qxu         , Qxu         , Qxu         , Qxu         , Re          , Re          , Ds          , Re          , Re          , Re          , Re          , Ur          , Ur          , Uu          , Uu          , Qxu         , Qxu         , Qxu         , Qxu         , Re          , Re          , Re          , Re          , Uu          , Uu          , Qxu         , Qxu         , Qxu         , Ur          , Qxu         , Qxu         , Qxu         , Qxu         , Qxu         , Qxu         , Qxu         , Qxu         , Qxu         , Qxu         
Qxu         , Qxu         , Qxu         , Qxu         , Qxu         , Qxu         , Qxu         , Qxu         , Qxu         , Qxu         , Qxu         , Qxu         , Qxu         , Re          , Qxu         , Qxu         , Qxu         , Uu          , Ur          , Uu          , Uu          , Qxu         , Qxu         , Qxu         , Qxu         , Qxu         , Qxu         , Qxu         , Qxu         , Uu          , Qxu         , Qxu         , Qxu         , Qxu         , Qxu         , Ur          , Qxu         , Qxu         , Qxu         , Qxu         , Qxu         , Qxu         , Qxu         , Qxu         , Qxu         , Qxu         
Qxu         , Qxu         , Qxu         , Qxu         , Qxu         , Qxu         , Qxu         , Qxu         , Uu          , Qxu         , Uu          , Qxu         , Uu          , Qxu         , Qxu         , Qxu         , Qxu         , Qxu         , Ur          , Uu          , Qxu         , Qxu         , Qxu         , Qxu         , Qxu         , Qxu         , Qxu         , Qxu         , Uu          , Uu          , Uu          , Qxu         , Qxu         , Qxu         , Uu          , Ur          , Uu          , Qxu         , Qxu         , Qxu         , Uu          , Re          , Re          , Qxu         , Qxu         , Qxu         
Uu          , Qxu         , Qxu         , Qxu         , Uu          , Qxu         , Uu          , Uu          , Uu^Vu       , Uu          , Ur          , Uu          , Ur          , Uu          , Uu          , Qxu         , Ur          , Qxu         , Ur          , Uu          , Qxu         , Qxu         , Qxu         , Qxu         , Qxu         , Qxu         , Qxu         , Qxu         , Uu          , Uu          , Ur          , Uu          , Ur          , Uu          , Ur          , Ur          , Uu          , Qxu         , Uu          , Uu          , Re^Vct      , Ce          , Re          , Re          , Qxu         , Qxu         
Uu          , Uu          , Uu          , Uu          , Uu          , Uu          , Uu          , Uu          , Uu          , Uu          , Ur          , Ur          , Uu          , Ur          , Ur          , Ur          , Qxu         , Ur          , Ur          , Uu          , Qxu         , Qxu         , Re          , Qxu         , Qxu         , Qxu         , Qxu         , Qxu         , Ur          , Ur          , Uu          , Ur          , Qxu         , Ur          , Qxu         , Ur          , Ur          , Ur          , Ur          , Ce          , Ce          , Ce          , Re^Vct      , Re          , Re          , Qxu         
Uu          , Uu          , Uu          , Uu          , Cud         , Uu          , Ur          , Ur          , Ur          , Ur          , Qxu         , Uu          , Qxu         , Qxu         , Qxu         , Qxu         , Qxu         , Uu          , Qxu         , Ur          , Re          , Re          , Ds          , Re          , Re          , Qxu         , Ur          , Ur          , Qxu         , Uu          , Qxu         , Qxu         , Qxu         , Qxu         , Qxu         , Ur          , Qxu         , Qxu         , Qxu         , Uu          , Ce          , 3 Ke        , Ce          , Re          , Re          , Gg          
Uu          , Uu          , Uu          , Uu          , 5 Kud       , Ur          , Uu          , Uu^Vu       , Re          , Re          , Re          , Qxu         , Qxu         , Qxu         , Qxu         , Qxu         , Qxu         , Qxu         , Qxu         , Qxu         , Re          , Ds          , Syt         , Ds          , Re          , Ur          , Uu          , Qxu         , Qxu         , Qxu         , Qxu         , Qxu         , Qxu         , Qxu         , Qxu         , Ur          , Uu          , Qxu         , Qxu         , Uu          , Uu          , Re^Vct      , Re          , Re          , Re          , Gg          
Uu          , Uu          , Uu          , Cud         , Uu          , Cud         , Uu          , Re          , Ds          , Ds          , Re          , Qxu         , Qxu         , Qxu         , Qxu         , Qxu         , Qxu         , Qxu         , Qxu         , Qxu         , Qxu         , Ds          , Ds          , Ds          , Re          , Uu          , Qxu         , Qxu         , Qxu         , Qxu         , Qxu         , Qxu         , Qxu         , Qxu         , Qxu         , Ur          , Uu          , Uu          , Qxu         , Qxu         , Qxu         , Uu          , Re          , Re          , Re          , Gs^Fp       
Re          , Re          , Re          , Uu          , Uu^Vu       , Uu          , Uu          , Re          , Re          , Re          , Qxu         , Qxu         , Qxu         , Qxu         , Qxu         , Qxu         , Qxu         , Qxu         , Qxu         , Qxu         , Qxu         , Re          , Re          , Re          , Uu          , Uu          , Uu          , Qxu         , Qxu         , Qxu         , Qxu         , Qxu         , Qxu         , Qxu         , Qxu         , Ur          , Ce          , Uu          , Qxu         , Qxu         , Qxu         , 2 Re        , Re          , Re          , Gg          , Gg          
Ds          , Ds          , Ds          , Re          , Re          , Uu          , Uu          , Qxu         , Qxu         , Qxu         , Qxu         , Qxu         , Qxu         , Qxu         , Qxu         , Qxu         , Qxu         , Qxu         , Qxu         , Qxu         , Qxu         , Qxu         , Qxu         , Qxu         , Qxu         , Qxu         , Qxu         , Uu          , Uu          , Uu          , Qxu         , Qxu         , Qxu         , Qxu         , Uu          , Uu          , Ce          , Uu          , Re          , Re          , Re          , Re          , Re          , Re          , Gg^Vh       , Gg          
Re          , Re          , Re          , Ds          , Re          , Uu          , Uu          , Qxu         , Qxu         , Qxu         , Qxu         , Qxu         , Qxu         , Qxu         , Qxu         , Qxu         , Qxu         , Qxu         , Qxu         , Qxu         , Qxu         , Qxu         , Qxu         , Qxu         , Qxu         , Qxu         , Qxu         , Uu          , Uu          , Uu          , Uu          , Qxu         , Qxu         , Uu          , Qxu         , Uu          , Ce          , Re^Vct      , Re^Vct      , Re          , Qxu         , Re          , Re          , Gg          , Gs^Fp       , Gg          
Uu          , Uu          , Uu          , Re          , Uu          , Uu          , Qxu         , Qxu         , Qxu         , Qxu         , Qxu         , Qxu         , Qxu         , Qxu         , Qxu         , Qxu         , Qxu         , Qxu         , Qxu         , Qxu         , Qxu         , Qxu         , Qxu         , Qxu         , Qxu         , Qxu         , Qxu         , Qxu         , Qxu         , Qxu         , Re          , Re          , Re          , Re          , Re^Vct      , Ce          , 1 Ke        , Ce          , Ce          , Re          , Re          , Re          , Gg          , Gg          , Gg          , Gs^Fp       
Uu          , Uu          , Uu          , Uu          , Qxu         , Qxu         , Qxu         , Qxu         , Qxu         , Qxu         , Qxu         , Qxu         , Qxu         , Qxu         , Qxu         , Qxu         , Qxu         , Qxu         , Qxu         , Qxu         , Qxu         , Qxu         , Qxu         , Qxu         , Qxu         , Qxu         , Qxu         , Qxu         , Re          , Re          , Gg          , Gg          , Gs^Fp       , Gg          , Gg          , Gg          , Gg          , Gs^Fp       , Gg          , Gg          , Gg          , Gg          , Gg          , Gg          , Gs^Fp       , Gs^Fp       
